MSOA21CD,Total: All usual residents aged 16 years and over,% Total: All usual residents aged 16 years and over,Economically active (excluding full-time students),% Economically active (excluding full-time students),Economically active (excluding full-time students):In employment,% Economically active (excluding full-time students):In employment,Economically active (excluding full-time students): Unemployed,% Economically active (excluding full-time students): Unemployed,Economically active and a full-time student,% Economically active and a full-time student,Economically active and a full-time student:In employment,% Economically active and a full-time student:In employment,Economically active and a full-time student: Unemployed,% Economically active and a full-time student: Unemployed,Economically inactive,% Economically inactive
E02002483,8178,100,4987,61,4799,58.7,188,2.3,162,2,130,1.6,32,0.4,3029,37
E02002484,8121,100,3958,48.7,3540,43.6,418,5.1,140,1.7,95,1.2,45,0.6,4023,49.5
E02002485,6231,100,3133,50.3,2861,45.9,272,4.4,106,1.7,82,1.3,24,0.4,2992,48
E02002489,5762,100,2721,47.2,2420,42,301,5.2,127,2.2,84,1.5,43,0.7,2914,50.6
E02002490,4615,100,2357,51.1,2131,46.2,226,4.9,50,1.1,30,0.7,20,0.4,2208,47.8
E02002491,5124,100,2508,48.9,2329,45.5,179,3.5,93,1.8,65,1.3,28,0.5,2523,49.2
E02002492,5476,100,2927,53.5,2766,50.5,161,2.9,70,1.3,51,0.9,19,0.3,2479,45.3
E02002493,5689,100,3122,54.9,3014,53,108,1.9,109,1.9,85,1.5,24,0.4,2458,43.2
E02002494,5840,100,2879,49.3,2624,44.9,255,4.4,94,1.6,65,1.1,29,0.5,2867,49.1
E02006909,10826,100,6094,56.3,5893,54.4,201,1.9,158,1.5,109,1,49,0.5,4574,42.3
E02007059,8833,100,4808,54.4,4474,50.7,334,3.8,153,1.7,104,1.2,49,0.6,3872,43.8
E02002496,9749,100,3307,33.9,2830,29,477,4.9,1229,12.6,690,7.1,539,5.5,5213,53.5
E02002497,4641,100,2245,48.4,1947,42,298,6.4,161,3.5,94,2,67,1.4,2235,48.2
E02002498,6675,100,2708,40.6,2261,33.9,447,6.7,619,9.3,357,5.3,262,3.9,3348,50.2
E02002499,5643,100,2906,51.5,2655,47,251,4.4,121,2.1,81,1.4,40,0.7,2616,46.4
E02002500,4668,100,2448,52.4,2252,48.2,196,4.2,153,3.3,102,2.2,51,1.1,2067,44.3
E02002501,4717,100,2523,53.5,2316,49.1,207,4.4,70,1.5,58,1.2,12,0.3,2124,45
E02002502,7518,100,3621,48.2,3216,42.8,405,5.4,144,1.9,92,1.2,52,0.7,3753,49.9
E02002503,5078,100,2845,56,2620,51.6,225,4.4,93,1.8,71,1.4,22,0.4,2140,42.1
E02002504,7705,100,4303,55.8,4071,52.8,232,3,217,2.8,169,2.2,48,0.6,3185,41.3
E02002505,4682,100,2444,52.2,2207,47.1,237,5.1,100,2.1,67,1.4,33,0.7,2138,45.7
E02002506,4405,100,2031,46.1,1860,42.2,171,3.9,103,2.3,62,1.4,41,0.9,2271,51.6
E02002507,5060,100,3008,59.4,2869,56.7,139,2.7,112,2.2,90,1.8,22,0.4,1940,38.3
E02002508,4469,100,2462,55.1,2341,52.4,121,2.7,103,2.3,74,1.7,29,0.6,1904,42.6
E02002509,4119,100,2198,53.4,2030,49.3,168,4.1,82,2,60,1.5,22,0.5,1839,44.6
E02002510,5858,100,3371,57.5,3254,55.5,117,2,114,1.9,90,1.5,24,0.4,2373,40.5
E02002512,4474,100,2457,54.9,2394,53.5,63,1.4,84,1.9,64,1.4,20,0.4,1933,43.2
E02002513,8251,100,4363,52.9,4080,49.4,283,3.4,155,1.9,110,1.3,45,0.5,3733,45.2
E02002514,6942,100,3677,53,3507,50.5,170,2.4,151,2.2,98,1.4,53,0.8,3114,44.9
E02006811,9298,100,5327,57.3,5151,55.4,176,1.9,208,2.2,155,1.7,53,0.6,3763,40.5
E02002515,5460,100,2802,51.3,2523,46.2,279,5.1,95,1.7,67,1.2,28,0.5,2563,46.9
E02002516,4656,100,2599,55.8,2461,52.9,138,3,97,2.1,70,1.5,27,0.6,1960,42.1
E02002517,4283,100,2166,50.6,2037,47.6,129,3,69,1.6,47,1.1,22,0.5,2048,47.8
E02002518,9098,100,5150,56.6,4964,54.6,186,2,172,1.9,141,1.5,31,0.3,3776,41.5
E02002519,5981,100,2784,46.5,2570,43,214,3.6,91,1.5,60,1,31,0.5,3106,51.9
E02002520,11067,100,5715,51.6,5475,49.5,240,2.2,213,1.9,153,1.4,60,0.5,5139,46.4
E02002521,5109,100,2357,46.1,2253,44.1,104,2,55,1.1,37,0.7,18,0.4,2697,52.8
E02002523,4601,100,2219,48.2,1895,41.2,324,7,73,1.6,55,1.2,18,0.4,2309,50.2
E02002524,4426,100,2213,50,2088,47.2,125,2.8,67,1.5,54,1.2,13,0.3,2146,48.5
E02002525,6737,100,3515,52.2,3292,48.9,223,3.3,89,1.3,59,0.9,30,0.4,3133,46.5
E02002526,6312,100,3389,53.7,3234,51.2,155,2.5,102,1.6,76,1.2,26,0.4,2821,44.7
E02002527,4004,100,2017,50.4,1836,45.9,181,4.5,39,1,25,0.6,14,0.3,1948,48.7
E02002529,4753,100,2479,52.2,2315,48.7,164,3.5,100,2.1,75,1.6,25,0.5,2174,45.7
E02002530,5225,100,2552,48.8,2384,45.6,168,3.2,55,1.1,41,0.8,14,0.3,2618,50.1
E02002532,5554,100,2909,52.4,2684,48.3,225,4.1,86,1.5,71,1.3,15,0.3,2559,46.1
E02002533,5412,100,2845,52.6,2745,50.7,100,1.8,84,1.6,59,1.1,25,0.5,2483,45.9
E02002534,4865,100,2308,47.4,2259,46.4,49,1,50,1,32,0.7,18,0.4,2507,51.5
E02006812,6243,100,3227,51.7,3032,48.6,195,3.1,124,2,105,1.7,19,0.3,2892,46.3
E02006910,8539,100,4556,53.4,4233,49.6,323,3.8,153,1.8,107,1.3,46,0.5,3830,44.9
E02002535,7736,100,4592,59.4,4434,57.3,158,2,126,1.6,94,1.2,32,0.4,3018,39
E02002536,7577,100,4119,54.4,3869,51.1,250,3.3,162,2.1,132,1.7,30,0.4,3296,43.5
E02002537,6469,100,3485,53.9,3226,49.9,259,4,144,2.2,114,1.8,30,0.5,2840,43.9
E02002538,4570,100,2530,55.4,2404,52.6,126,2.8,56,1.2,49,1.1,7,0.2,1984,43.4
E02002539,8671,100,4977,57.4,4799,55.3,178,2.1,177,2,141,1.6,36,0.4,3517,40.6
E02002540,5154,100,2756,53.5,2667,51.7,89,1.7,81,1.6,53,1,28,0.5,2317,45
E02002541,5022,100,2837,56.5,2674,53.2,163,3.2,76,1.5,51,1,25,0.5,2109,42
E02002542,6257,100,3335,53.3,3013,48.2,322,5.1,117,1.9,80,1.3,37,0.6,2805,44.8
E02002543,6977,100,3963,56.8,3645,52.2,318,4.6,107,1.5,67,1,40,0.6,2907,41.7
E02002544,7414,100,3798,51.2,3456,46.6,342,4.6,121,1.6,85,1.1,36,0.5,3495,47.1
E02002545,4276,100,2390,55.9,2278,53.3,112,2.6,66,1.5,54,1.3,12,0.3,1820,42.6
E02002546,5819,100,3188,54.8,2862,49.2,326,5.6,103,1.8,76,1.3,27,0.5,2528,43.4
E02002547,5168,100,2549,49.3,2472,47.8,77,1.5,90,1.7,65,1.3,25,0.5,2529,48.9
E02002549,6301,100,3341,53,3221,51.1,120,1.9,102,1.6,78,1.2,24,0.4,2858,45.4
E02002550,4954,100,2729,55.1,2587,52.2,142,2.9,87,1.8,71,1.4,16,0.3,2138,43.2
E02002551,4345,100,2217,51,1994,45.9,223,5.1,113,2.6,79,1.8,34,0.8,2015,46.4
E02002552,5550,100,3259,58.7,3061,55.2,198,3.6,115,2.1,90,1.6,25,0.5,2176,39.2
E02002553,4630,100,2564,55.4,2399,51.8,165,3.6,73,1.6,60,1.3,13,0.3,1993,43
E02002554,4107,100,1966,47.9,1795,43.7,171,4.2,62,1.5,36,0.9,26,0.6,2079,50.6
E02002555,8301,100,4632,55.8,4470,53.8,162,2,151,1.8,103,1.2,48,0.6,3518,42.4
E02002556,6002,100,3598,59.9,3475,57.9,123,2,116,1.9,83,1.4,33,0.5,2288,38.1
E02002558,9141,100,5202,56.9,5009,54.8,193,2.1,133,1.5,98,1.1,35,0.4,3806,41.6
E02007060,4838,100,2411,49.8,2067,42.7,344,7.1,137,2.8,95,2,42,0.9,2290,47.3
E02007061,6182,100,3759,60.8,3406,55.1,353,5.7,140,2.3,108,1.7,32,0.5,2283,36.9
E02007062,5598,100,4096,73.2,4004,71.5,92,1.6,153,2.7,132,2.4,21,0.4,1349,24.1
E02007063,6947,100,5016,72.2,4883,70.3,133,1.9,223,3.2,177,2.5,46,0.7,1708,24.6
E02002559,7867,100,4980,63.3,4853,61.7,127,1.6,123,1.6,91,1.2,32,0.4,2764,35.1
E02002560,5062,100,3141,62.1,3035,60,106,2.1,113,2.2,78,1.5,35,0.7,1808,35.7
E02002561,4597,100,2478,53.9,2383,51.8,95,2.1,74,1.6,53,1.2,21,0.5,2045,44.5
E02002562,4638,100,2655,57.2,2430,52.4,225,4.9,75,1.6,61,1.3,14,0.3,1908,41.1
E02002563,4606,100,2459,53.4,2347,51,112,2.4,64,1.4,49,1.1,15,0.3,2083,45.2
E02002564,7820,100,4512,57.7,4259,54.5,253,3.2,160,2,123,1.6,37,0.5,3148,40.3
E02002567,7311,100,4345,59.4,4101,56.1,244,3.3,159,2.2,119,1.6,40,0.5,2807,38.4
E02002568,5061,100,2749,54.3,2649,52.3,100,2,85,1.7,65,1.3,20,0.4,2227,44
E02002569,7743,100,3871,50,3779,48.8,92,1.2,131,1.7,100,1.3,31,0.4,3741,48.3
E02002570,6199,100,3475,56.1,3189,51.4,286,4.6,80,1.3,62,1,18,0.3,2644,42.7
E02002571,4983,100,2961,59.4,2765,55.5,196,3.9,89,1.8,72,1.4,17,0.3,1933,38.8
E02002572,4911,100,2904,59.1,2673,54.4,231,4.7,77,1.6,66,1.3,11,0.2,1930,39.3
E02002573,7676,100,4419,57.6,4301,56,118,1.5,145,1.9,111,1.4,34,0.4,3112,40.5
E02007058,9631,100,5819,60.4,5337,55.4,482,5,185,1.9,144,1.5,41,0.4,3627,37.7
E02004290,4909,100,2818,57.4,2721,55.4,97,2,82,1.7,68,1.4,14,0.3,2009,40.9
E02004291,5877,100,3431,58.4,3271,55.7,160,2.7,92,1.6,69,1.2,23,0.4,2354,40.1
E02004292,6774,100,3640,53.7,3550,52.4,90,1.3,88,1.3,66,1,22,0.3,3046,45
E02004293,7839,100,4344,55.4,4092,52.2,252,3.2,154,2,120,1.5,34,0.4,3341,42.6
E02004294,6791,100,3681,54.2,3560,52.4,121,1.8,131,1.9,107,1.6,24,0.4,2979,43.9
E02004295,6086,100,3208,52.7,3051,50.1,157,2.6,86,1.4,66,1.1,20,0.3,2792,45.9
E02004296,6974,100,3902,56,3690,52.9,212,3,135,1.9,100,1.4,35,0.5,2937,42.1
E02004297,6623,100,3877,58.5,3720,56.2,157,2.4,88,1.3,63,1,25,0.4,2658,40.1
E02004298,8356,100,4600,55.1,4454,53.3,146,1.7,114,1.4,86,1,28,0.3,3642,43.6
E02004299,6819,100,3698,54.2,3489,51.2,209,3.1,113,1.7,77,1.1,36,0.5,3008,44.1
E02004300,6266,100,3187,50.9,2999,47.9,188,3,81,1.3,60,1,21,0.3,2998,47.8
E02004301,7599,100,4194,55.2,3942,51.9,252,3.3,137,1.8,91,1.2,46,0.6,3268,43
E02004302,6407,100,3414,53.3,3127,48.8,287,4.5,85,1.3,65,1,20,0.3,2908,45.4
E02004303,9334,100,5438,58.3,5146,55.1,292,3.1,148,1.6,121,1.3,27,0.3,3748,40.2
E02004304,7232,100,4176,57.7,3967,54.9,209,2.9,114,1.6,85,1.2,29,0.4,2942,40.7
E02004305,8065,100,4851,60.1,4614,57.2,237,2.9,156,1.9,115,1.4,41,0.5,3058,37.9
E02004306,4936,100,2554,51.7,2469,50,85,1.7,53,1.1,36,0.7,17,0.3,2329,47.2
E02004307,5393,100,3150,58.4,3020,56,130,2.4,66,1.2,46,0.9,20,0.4,2177,40.4
E02004308,6703,100,3225,48.1,3138,46.8,87,1.3,85,1.3,62,0.9,23,0.3,3393,50.6
E02004309,5109,100,2757,54,2638,51.6,119,2.3,77,1.5,61,1.2,16,0.3,2275,44.5
E02004310,6430,100,3565,55.4,3419,53.2,146,2.3,103,1.6,72,1.1,31,0.5,2762,43
E02004311,7652,100,4303,56.2,4099,53.6,204,2.7,105,1.4,80,1,25,0.3,3244,42.4
E02004312,6348,100,3205,50.5,3127,49.3,78,1.2,125,2,106,1.7,19,0.3,3018,47.5
E02004313,5714,100,2320,40.6,2124,37.2,196,3.4,340,6,276,4.8,64,1.1,3054,53.4
E02004314,12399,100,1080,8.7,1021,8.2,59,0.5,1456,11.7,1017,8.2,439,3.5,9863,79.5
E02004315,11165,100,5083,45.5,4929,44.1,154,1.4,610,5.5,448,4,162,1.5,5472,49
E02004316,5266,100,3010,57.2,2857,54.3,153,2.9,48,0.9,33,0.6,15,0.3,2208,41.9
E02004317,6149,100,3164,51.5,2963,48.2,201,3.3,88,1.4,70,1.1,18,0.3,2897,47.1
E02004318,5482,100,3094,56.4,2947,53.8,147,2.7,71,1.3,56,1,15,0.3,2317,42.3
E02004319,6587,100,3916,59.5,3780,57.4,136,2.1,113,1.7,84,1.3,29,0.4,2558,38.8
E02004320,7102,100,4030,56.7,3922,55.2,108,1.5,109,1.5,80,1.1,29,0.4,2963,41.7
E02004321,6732,100,3549,52.7,3337,49.6,212,3.1,104,1.5,86,1.3,18,0.3,3079,45.7
E02004322,6853,100,3283,47.9,3041,44.4,242,3.5,86,1.3,57,0.8,29,0.4,3484,50.8
E02004323,6087,100,3488,57.3,3336,54.8,152,2.5,89,1.5,64,1.1,25,0.4,2510,41.2
E02004324,4785,100,2481,51.8,2336,48.8,145,3,65,1.4,44,0.9,21,0.4,2239,46.8
E02004325,7091,100,3467,48.9,3208,45.2,259,3.7,98,1.4,68,1,30,0.4,3526,49.7
E02004326,5467,100,2952,54,2803,51.3,149,2.7,86,1.6,73,1.3,13,0.2,2429,44.4
E02004327,4654,100,2118,45.5,1897,40.8,221,4.7,67,1.4,48,1,19,0.4,2469,53.1
E02004328,5781,100,3102,53.7,2900,50.2,202,3.5,101,1.7,70,1.2,31,0.5,2578,44.6
E02004329,5504,100,2770,50.3,2631,47.8,139,2.5,73,1.3,51,0.9,22,0.4,2661,48.3
E02004330,5044,100,2383,47.2,2225,44.1,158,3.1,55,1.1,41,0.8,14,0.3,2606,51.7
E02004331,5926,100,3148,53.1,2988,50.4,160,2.7,48,0.8,37,0.6,11,0.2,2730,46.1
E02004332,6011,100,3353,55.8,3223,53.6,130,2.2,96,1.6,75,1.2,21,0.3,2562,42.6
E02004333,5738,100,2947,51.4,2857,49.8,90,1.6,91,1.6,67,1.2,24,0.4,2700,47.1
E02004334,5758,100,3134,54.4,2969,51.6,165,2.9,68,1.2,54,0.9,14,0.2,2556,44.4
E02004335,6255,100,3564,57,3374,53.9,190,3,103,1.6,72,1.2,31,0.5,2588,41.4
E02004336,5623,100,2747,48.9,2602,46.3,145,2.6,65,1.2,48,0.9,17,0.3,2811,50
E02004337,8619,100,4993,57.9,4772,55.4,221,2.6,118,1.4,79,0.9,39,0.5,3508,40.7
E02004338,6112,100,3525,57.7,3344,54.7,181,3,83,1.4,59,1,24,0.4,2504,41
E02004339,5900,100,3285,55.7,3223,54.6,62,1.1,112,1.9,78,1.3,34,0.6,2503,42.4
E02004340,8502,100,4361,51.3,4056,47.7,305,3.6,124,1.5,91,1.1,33,0.4,4017,47.2
E02004341,7359,100,4289,58.3,4166,56.6,123,1.7,127,1.7,89,1.2,38,0.5,2943,40
E02004342,4246,100,2129,50.1,1962,46.2,167,3.9,94,2.2,65,1.5,29,0.7,2023,47.6
E02004343,4555,100,2443,53.6,2323,51,120,2.6,81,1.8,63,1.4,18,0.4,2031,44.6
E02004344,5759,100,2891,50.2,2740,47.6,151,2.6,83,1.4,56,1,27,0.5,2785,48.4
E02004345,10738,100,5790,53.9,5587,52,203,1.9,128,1.2,88,0.8,40,0.4,4820,44.9
E02004348,6772,100,3490,51.5,3391,50.1,99,1.5,57,0.8,44,0.6,13,0.2,3225,47.6
E02004349,7509,100,4021,53.5,3767,50.2,254,3.4,79,1.1,47,0.6,32,0.4,3409,45.4
E02004350,8154,100,4464,54.7,4268,52.3,196,2.4,89,1.1,65,0.8,24,0.3,3601,44.2
E02004351,5860,100,2900,49.5,2705,46.2,195,3.3,82,1.4,51,0.9,31,0.5,2878,49.1
E02004352,6715,100,3653,54.4,3416,50.9,237,3.5,101,1.5,71,1.1,30,0.4,2961,44.1
E02004353,6073,100,3284,54.1,3173,52.2,111,1.8,107,1.8,75,1.2,32,0.5,2682,44.2
E02004354,7362,100,4180,56.8,3970,53.9,210,2.9,80,1.1,58,0.8,22,0.3,3102,42.1
E02004355,5595,100,2778,49.7,2598,46.4,180,3.2,67,1.2,50,0.9,17,0.3,2750,49.2
E02007022,10436,100,5337,51.1,5137,49.2,200,1.9,108,1,72,0.7,36,0.3,4991,47.8
E02005702,5752,100,3022,52.5,2919,50.7,103,1.8,51,0.9,42,0.7,9,0.2,2679,46.6
E02005703,5843,100,3069,52.5,2881,49.3,188,3.2,70,1.2,54,0.9,16,0.3,2704,46.3
E02005704,10880,100,5625,51.7,5369,49.3,256,2.4,122,1.1,98,0.9,24,0.2,5133,47.2
E02005705,6619,100,3369,50.9,3227,48.8,142,2.1,64,1,45,0.7,19,0.3,3186,48.1
E02005706,7596,100,4091,53.9,3845,50.6,246,3.2,101,1.3,74,1,27,0.4,3404,44.8
E02005707,6116,100,3113,50.9,3004,49.1,109,1.8,69,1.1,55,0.9,14,0.2,2934,48
E02005708,8809,100,4405,50,4226,48,179,2,67,0.8,49,0.6,18,0.2,4337,49.2
E02005709,5321,100,2702,50.8,2399,45.1,303,5.7,73,1.4,53,1,20,0.4,2546,47.8
E02005710,7806,100,4332,55.5,4058,52,274,3.5,99,1.3,65,0.8,34,0.4,3375,43.2
E02005711,6281,100,3237,51.5,2999,47.7,238,3.8,87,1.4,63,1,24,0.4,2957,47.1
E02005712,7411,100,4787,64.6,4527,61.1,260,3.5,107,1.4,85,1.1,22,0.3,2517,34
E02005713,5322,100,2995,56.3,2938,55.2,57,1.1,84,1.6,72,1.4,12,0.2,2243,42.1
E02005715,7443,100,4196,56.4,3884,52.2,312,4.2,89,1.2,67,0.9,22,0.3,3158,42.4
E02005717,6352,100,3288,51.8,3139,49.4,149,2.3,100,1.6,73,1.1,27,0.4,2964,46.7
E02005718,5454,100,2730,50.1,2623,48.1,107,2,67,1.2,56,1,11,0.2,2657,48.7
E02005719,6910,100,3964,57.4,3742,54.2,222,3.2,90,1.3,60,0.9,30,0.4,2856,41.3
E02005720,10445,100,5108,48.9,4816,46.1,292,2.8,79,0.8,62,0.6,17,0.2,5258,50.3
E02005721,4541,100,2519,55.5,2423,53.4,96,2.1,57,1.3,48,1.1,9,0.2,1965,43.3
E02005722,7903,100,4777,60.4,4672,59.1,105,1.3,107,1.4,83,1.1,24,0.3,3019,38.2
E02005723,5149,100,2497,48.5,2355,45.7,142,2.8,83,1.6,71,1.4,12,0.2,2569,49.9
E02005724,5503,100,2829,51.4,2728,49.6,101,1.8,60,1.1,36,0.7,24,0.4,2614,47.5
E02005725,5888,100,3015,51.2,2924,49.7,91,1.5,61,1,44,0.7,17,0.3,2812,47.8
E02005726,6633,100,3555,53.6,3468,52.3,87,1.3,84,1.3,68,1,16,0.2,2994,45.1
E02005727,5209,100,2975,57.1,2911,55.9,64,1.2,37,0.7,28,0.5,9,0.2,2197,42.2
E02005728,5752,100,3044,52.9,2928,50.9,116,2,62,1.1,51,0.9,11,0.2,2646,46
E02005729,4715,100,2614,55.4,2510,53.2,104,2.2,60,1.3,46,1,14,0.3,2041,43.3
E02005730,10756,100,5552,51.6,5332,49.6,220,2,115,1.1,95,0.9,20,0.2,5089,47.3
E02005731,8856,100,5082,57.4,4898,55.3,184,2.1,158,1.8,121,1.4,37,0.4,3616,40.8
E02005733,7033,100,3947,56.1,3826,54.4,121,1.7,77,1.1,55,0.8,22,0.3,3009,42.8
E02005734,4936,100,2368,48,2181,44.2,187,3.8,51,1,31,0.6,20,0.4,2517,51
E02005735,5676,100,3009,53,2683,47.3,326,5.7,69,1.2,53,0.9,16,0.3,2598,45.8
E02005736,6925,100,3855,55.7,3572,51.6,283,4.1,93,1.3,72,1,21,0.3,2977,43
E02005739,7593,100,4075,53.7,3821,50.3,254,3.3,93,1.2,67,0.9,26,0.3,3425,45.1
E02005740,8283,100,4481,54.1,4199,50.7,282,3.4,128,1.5,94,1.1,34,0.4,3674,44.4
E02005741,7130,100,4005,56.2,3862,54.2,143,2,99,1.4,77,1.1,22,0.3,3026,42.4
E02007105,10450,100,5867,56.1,5593,53.5,274,2.6,132,1.3,109,1,23,0.2,4451,42.6
E02007106,12049,100,7333,60.9,7025,58.3,308,2.6,261,2.2,209,1.7,52,0.4,4455,37
E02007107,7495,100,3769,50.3,3667,48.9,102,1.4,82,1.1,65,0.9,17,0.2,3644,48.6
E02001709,8470,100,4936,58.3,4786,56.5,150,1.8,154,1.8,105,1.2,49,0.6,3380,39.9
E02001710,8198,100,4350,53.1,4014,49,336,4.1,172,2.1,126,1.5,46,0.6,3676,44.8
E02001711,7906,100,4369,55.3,4114,52,255,3.2,107,1.4,75,0.9,32,0.4,3430,43.4
E02001712,7815,100,4510,57.7,4363,55.8,147,1.9,223,2.9,158,2,65,0.8,3082,39.4
E02001713,8237,100,4786,58.1,4639,56.3,147,1.8,165,2,113,1.4,52,0.6,3286,39.9
E02001714,7905,100,4927,62.3,4774,60.4,153,1.9,142,1.8,111,1.4,31,0.4,2836,35.9
E02001715,9036,100,4920,54.4,4611,51,309,3.4,190,2.1,132,1.5,58,0.6,3926,43.4
E02001718,5277,100,2972,56.3,2806,53.2,166,3.1,85,1.6,64,1.2,21,0.4,2220,42.1
E02001719,7247,100,4341,59.9,4154,57.3,187,2.6,185,2.6,149,2.1,36,0.5,2721,37.5
E02001720,9032,100,2394,26.5,2302,25.5,92,1,1388,15.4,989,10.9,399,4.4,5250,58.1
E02001721,8858,100,4890,55.2,4665,52.7,225,2.5,138,1.6,104,1.2,34,0.4,3830,43.2
E02001722,7521,100,4064,54,3821,50.8,243,3.2,125,1.7,88,1.2,37,0.5,3332,44.3
E02001723,5470,100,3125,57.1,2935,53.7,190,3.5,118,2.2,91,1.7,27,0.5,2227,40.7
E02001724,8517,100,3037,35.7,2907,34.1,130,1.5,1230,14.4,928,10.9,302,3.5,4250,49.9
E02001725,8362,100,4892,58.5,4598,55,294,3.5,730,8.7,545,6.5,185,2.2,2740,32.8
E02001726,9322,100,5178,55.5,4848,52,330,3.5,240,2.6,170,1.8,70,0.8,3904,41.9
E02001727,7266,100,4068,56,3836,52.8,232,3.2,103,1.4,74,1,29,0.4,3095,42.6
E02001728,7713,100,4425,57.4,4188,54.3,237,3.1,163,2.1,128,1.7,35,0.5,3125,40.5
E02001729,9773,100,4196,42.9,3743,38.3,453,4.6,888,9.1,573,5.9,315,3.2,4689,48
E02001732,4469,100,2490,55.7,2345,52.5,145,3.2,90,2,56,1.3,34,0.8,1889,42.3
E02001734,6285,100,3223,51.3,2960,47.1,263,4.2,129,2.1,100,1.6,29,0.5,2933,46.7
E02001735,5092,100,2528,49.6,2295,45.1,233,4.6,96,1.9,71,1.4,25,0.5,2468,48.5
E02001737,4812,100,2334,48.5,2062,42.9,272,5.7,56,1.2,36,0.7,20,0.4,2422,50.3
E02006893,9215,100,4870,52.8,4687,50.9,183,2,132,1.4,103,1.1,29,0.3,4213,45.7
E02007095,7630,100,5309,69.6,5175,67.8,134,1.8,145,1.9,100,1.3,45,0.6,2176,28.5
E02007096,4820,100,2898,60.1,2781,57.7,117,2.4,97,2,76,1.6,21,0.4,1825,37.9
E02007097,8161,100,2524,30.9,2391,29.3,133,1.6,1559,19.1,1042,12.8,517,6.3,4078,50
E02007098,5270,100,2735,51.9,2464,46.8,271,5.1,135,2.6,96,1.8,39,0.7,2400,45.5
E02007099,9945,100,2597,26.1,2371,23.8,226,2.3,1484,14.9,947,9.5,537,5.4,5864,59
E02007100,8134,100,1814,22.3,1652,20.3,162,2,1850,22.7,1083,13.3,767,9.4,4470,55
E02007101,6692,100,3006,44.9,2624,39.2,382,5.7,269,4,201,3,68,1,3417,51.1
E02007102,6614,100,1952,29.5,1745,26.4,207,3.1,690,10.4,464,7,226,3.4,3972,60.1
E02007103,5188,100,2776,53.5,2512,48.4,264,5.1,178,3.4,116,2.2,62,1.2,2234,43.1
E02007104,4205,100,1853,44.1,1600,38,253,6,150,3.6,98,2.3,52,1.2,2202,52.4
E02001738,5089,100,2475,48.6,2432,47.8,43,0.8,87,1.7,66,1.3,21,0.4,2527,49.7
E02001739,6141,100,3454,56.2,3279,53.4,175,2.8,83,1.4,54,0.9,29,0.5,2604,42.4
E02001740,4642,100,2702,58.2,2623,56.5,79,1.7,112,2.4,79,1.7,33,0.7,1828,39.4
E02001741,6555,100,3579,54.6,3468,52.9,111,1.7,116,1.8,93,1.4,23,0.4,2860,43.6
E02001742,4846,100,2685,55.4,2621,54.1,64,1.3,82,1.7,63,1.3,19,0.4,2079,42.9
E02001743,6200,100,3797,61.2,3655,59,142,2.3,101,1.6,77,1.2,24,0.4,2302,37.1
E02001744,6593,100,4294,65.1,4147,62.9,147,2.2,119,1.8,93,1.4,26,0.4,2180,33.1
E02001745,5394,100,3338,61.9,3197,59.3,141,2.6,100,1.9,79,1.5,21,0.4,1956,36.3
E02001746,6669,100,3859,57.9,3707,55.6,152,2.3,131,2,86,1.3,45,0.7,2679,40.2
E02001747,5270,100,2741,52,2648,50.2,93,1.8,87,1.7,63,1.2,24,0.5,2442,46.3
E02001748,6842,100,4417,64.6,4238,61.9,179,2.6,130,1.9,88,1.3,42,0.6,2295,33.5
E02001749,5294,100,3035,57.3,2918,55.1,117,2.2,78,1.5,54,1,24,0.5,2181,41.2
E02001750,5618,100,3220,57.3,3121,55.6,99,1.8,103,1.8,72,1.3,31,0.6,2295,40.9
E02001751,5446,100,3310,60.8,3172,58.2,138,2.5,84,1.5,60,1.1,24,0.4,2052,37.7
E02001752,5049,100,2795,55.4,2611,51.7,184,3.6,120,2.4,84,1.7,36,0.7,2134,42.3
E02001753,5242,100,2942,56.1,2822,53.8,120,2.3,67,1.3,47,0.9,20,0.4,2233,42.6
E02001754,4907,100,2922,59.5,2823,57.5,99,2,80,1.6,60,1.2,20,0.4,1905,38.8
E02001755,8050,100,5043,62.6,4869,60.5,174,2.2,132,1.6,98,1.2,34,0.4,2875,35.7
E02001756,7571,100,4658,61.5,4411,58.3,247,3.3,107,1.4,79,1,28,0.4,2806,37.1
E02001757,4949,100,2733,55.2,2619,52.9,114,2.3,54,1.1,37,0.7,17,0.3,2162,43.7
E02001758,4562,100,2699,59.2,2570,56.3,129,2.8,56,1.2,34,0.7,22,0.5,1807,39.6
E02001759,5338,100,3189,59.7,2994,56.1,195,3.7,75,1.4,53,1,22,0.4,2074,38.9
E02001760,5927,100,3333,56.2,3051,51.5,282,4.8,109,1.8,73,1.2,36,0.6,2485,41.9
E02001761,4611,100,2568,55.7,2443,53,125,2.7,66,1.4,44,1,22,0.5,1977,42.9
E02001762,5535,100,3523,63.6,3377,61,146,2.6,97,1.8,72,1.3,25,0.5,1915,34.6
E02001763,5278,100,2976,56.4,2746,52,230,4.4,87,1.6,56,1.1,31,0.6,2215,42
E02001764,6244,100,3419,54.8,3091,49.5,328,5.3,86,1.4,59,0.9,27,0.4,2739,43.9
E02001765,6052,100,3405,56.3,3162,52.2,243,4,107,1.8,76,1.3,31,0.5,2540,42
E02001766,5844,100,3635,62.2,3346,57.3,289,4.9,90,1.5,68,1.2,22,0.4,2119,36.3
E02001767,5758,100,3280,57,3064,53.2,216,3.8,92,1.6,70,1.2,22,0.4,2386,41.4
E02001768,6664,100,3622,54.4,3312,49.7,310,4.7,127,1.9,93,1.4,34,0.5,2915,43.7
E02001769,6211,100,3133,50.4,2752,44.3,381,6.1,109,1.8,77,1.2,32,0.5,2969,47.8
E02001770,5192,100,2972,57.2,2798,53.9,174,3.4,115,2.2,91,1.8,24,0.5,2105,40.5
E02001771,5015,100,2476,49.4,2313,46.1,163,3.3,88,1.8,57,1.1,31,0.6,2451,48.9
E02001772,4223,100,2272,53.8,2091,49.5,181,4.3,77,1.8,53,1.3,24,0.6,1874,44.4
E02001773,4488,100,2289,51,2176,48.5,113,2.5,70,1.6,53,1.2,17,0.4,2129,47.4
E02001774,4332,100,2267,52.3,2098,48.4,169,3.9,72,1.7,49,1.1,23,0.5,1993,46
E02001775,4363,100,2282,52.3,2093,48,189,4.3,66,1.5,44,1,22,0.5,2015,46.2
E02001776,7281,100,4277,58.7,3989,54.8,288,4,96,1.3,66,0.9,30,0.4,2908,39.9
E02001777,5643,100,3588,63.6,3404,60.3,184,3.3,93,1.6,74,1.3,19,0.3,1962,34.8
E02001778,4732,100,2571,54.3,2337,49.4,234,4.9,90,1.9,58,1.2,32,0.7,2071,43.8
E02001779,4399,100,2235,50.8,1982,45.1,253,5.8,59,1.3,39,0.9,20,0.5,2105,47.9
E02001780,4891,100,2558,52.3,2371,48.5,187,3.8,77,1.6,45,0.9,32,0.7,2256,46.1
E02001781,4245,100,2287,53.9,2111,49.7,176,4.1,68,1.6,42,1,26,0.6,1890,44.5
E02001782,8101,100,4622,57.1,4390,54.2,232,2.9,115,1.4,88,1.1,27,0.3,3364,41.5
E02001783,5423,100,2978,54.9,2634,48.6,344,6.3,68,1.3,33,0.6,35,0.6,2377,43.8
E02001784,5356,100,2856,53.3,2657,49.6,199,3.7,94,1.8,50,0.9,44,0.8,2406,44.9
E02001785,6354,100,3276,51.6,3102,48.8,174,2.7,100,1.6,64,1,36,0.6,2978,46.9
E02001786,5444,100,2928,53.8,2730,50.1,198,3.6,78,1.4,57,1,21,0.4,2438,44.8
E02001787,4393,100,2316,52.7,2161,49.2,155,3.5,77,1.8,53,1.2,24,0.5,2000,45.5
E02001788,4779,100,2648,55.4,2484,52,164,3.4,73,1.5,51,1.1,22,0.5,2058,43.1
E02001789,4884,100,2673,54.7,2593,53.1,80,1.6,95,1.9,71,1.5,24,0.5,2116,43.3
E02001790,4877,100,2672,54.8,2563,52.6,109,2.2,94,1.9,61,1.3,33,0.7,2111,43.3
E02001791,4696,100,2785,59.3,2711,57.7,74,1.6,65,1.4,49,1,16,0.3,1846,39.3
E02001792,5978,100,3126,52.3,3029,50.7,97,1.6,95,1.6,76,1.3,19,0.3,2757,46.1
E02001793,6542,100,3507,53.6,3237,49.5,270,4.1,100,1.5,71,1.1,29,0.4,2935,44.9
E02001794,7050,100,3509,49.8,3256,46.2,253,3.6,107,1.5,69,1,38,0.5,3434,48.7
E02001795,6013,100,3048,50.7,2790,46.4,258,4.3,103,1.7,70,1.2,33,0.5,2862,47.6
E02001796,7442,100,3865,51.9,3651,49.1,214,2.9,229,3.1,135,1.8,94,1.3,3348,45
E02001797,4985,100,2798,56.1,2673,53.6,125,2.5,97,1.9,60,1.2,37,0.7,2090,41.9
E02001798,6681,100,3722,55.7,3505,52.5,217,3.2,100,1.5,75,1.1,25,0.4,2859,42.8
E02001799,7420,100,3911,52.7,3547,47.8,364,4.9,119,1.6,69,0.9,50,0.7,3390,45.7
E02001800,5539,100,3116,56.3,2957,53.4,159,2.9,79,1.4,53,1,26,0.5,2344,42.3
E02001801,4781,100,2337,48.9,2166,45.3,171,3.6,394,8.2,215,4.5,179,3.7,2050,42.9
E02001802,5680,100,3063,53.9,2789,49.1,274,4.8,88,1.5,71,1.2,17,0.3,2529,44.5
E02001803,7468,100,3288,44,2981,39.9,307,4.1,672,9,382,5.1,290,3.9,3508,47
E02001804,5111,100,2767,54.1,2576,50.4,191,3.7,56,1.1,35,0.7,21,0.4,2288,44.8
E02001805,4722,100,2474,52.4,2359,50,115,2.4,68,1.4,58,1.2,10,0.2,2180,46.2
E02001806,6300,100,2914,46.3,2555,40.6,359,5.7,152,2.4,98,1.6,54,0.9,3234,51.3
E02001807,6811,100,4047,59.4,3857,56.6,190,2.8,142,2.1,101,1.5,41,0.6,2622,38.5
E02001808,4490,100,2485,55.3,2354,52.4,131,2.9,164,3.7,104,2.3,60,1.3,1841,41
E02001809,5413,100,2836,52.4,2702,49.9,134,2.5,82,1.5,59,1.1,23,0.4,2495,46.1
E02001810,6875,100,3894,56.6,3683,53.6,211,3.1,113,1.6,77,1.1,36,0.5,2868,41.7
E02001811,7048,100,3625,51.4,3320,47.1,305,4.3,67,1,47,0.7,20,0.3,3356,47.6
E02001812,8562,100,4409,51.5,4248,49.6,161,1.9,140,1.6,115,1.3,25,0.3,4013,46.9
E02001813,7601,100,4032,53,3685,48.5,347,4.6,110,1.4,77,1,33,0.4,3459,45.5
E02001814,5079,100,2768,54.5,2567,50.5,201,4,95,1.9,70,1.4,25,0.5,2216,43.6
E02001815,8258,100,4444,53.8,4270,51.7,174,2.1,104,1.3,81,1,23,0.3,3710,44.9
E02001816,5699,100,2864,50.3,2684,47.1,180,3.2,73,1.3,54,0.9,19,0.3,2762,48.5
E02001817,5466,100,2949,54,2777,50.8,172,3.1,98,1.8,74,1.4,24,0.4,2419,44.3
E02001818,7595,100,4380,57.7,4146,54.6,234,3.1,160,2.1,116,1.5,44,0.6,3055,40.2
E02001819,5961,100,3176,53.3,3070,51.5,106,1.8,86,1.4,74,1.2,12,0.2,2699,45.3
E02001820,7802,100,4641,59.5,4389,56.3,252,3.2,123,1.6,82,1.1,41,0.5,3038,38.9
E02001821,4746,100,2720,57.3,2621,55.2,99,2.1,100,2.1,74,1.6,26,0.5,1926,40.6
E02001822,6438,100,3758,58.4,3598,55.9,160,2.5,87,1.4,69,1.1,18,0.3,2593,40.3
E02001823,6477,100,3876,59.8,3697,57.1,179,2.8,81,1.3,63,1,18,0.3,2520,38.9
E02001824,7003,100,3645,52,3409,48.7,236,3.4,96,1.4,67,1,29,0.4,3262,46.6
E02001825,6509,100,3384,52,3211,49.3,173,2.7,74,1.1,50,0.8,24,0.4,3051,46.9
E02001826,5806,100,3158,54.4,2966,51.1,192,3.3,90,1.6,61,1.1,29,0.5,2558,44.1
E02001682,7036,100,4148,59,3953,56.2,195,2.8,103,1.5,65,0.9,38,0.5,2785,39.6
E02001683,7856,100,4662,59.3,4463,56.8,199,2.5,97,1.2,78,1,19,0.2,3097,39.4
E02001684,5391,100,3024,56.1,2776,51.5,248,4.6,100,1.9,59,1.1,41,0.8,2267,42.1
E02001685,6456,100,3735,57.9,3514,54.4,221,3.4,108,1.7,74,1.1,34,0.5,2613,40.5
E02001686,5745,100,3189,55.5,3051,53.1,138,2.4,89,1.5,73,1.3,16,0.3,2467,42.9
E02001688,6290,100,3838,61,3571,56.8,267,4.2,109,1.7,81,1.3,28,0.4,2343,37.2
E02001689,5835,100,3146,53.9,2861,49,285,4.9,138,2.4,107,1.8,31,0.5,2551,43.7
E02001690,5891,100,3382,57.4,3200,54.3,182,3.1,108,1.8,66,1.1,42,0.7,2401,40.8
E02001691,6729,100,4199,62.4,3911,58.1,288,4.3,134,2,110,1.6,24,0.4,2396,35.6
E02001692,4892,100,2639,53.9,2398,49,241,4.9,87,1.8,63,1.3,24,0.5,2166,44.3
E02001693,4364,100,2173,49.8,2012,46.1,161,3.7,54,1.2,40,0.9,14,0.3,2137,49
E02001694,5207,100,3005,57.7,2851,54.8,154,3,99,1.9,69,1.3,30,0.6,2103,40.4
E02001695,4900,100,2762,56.4,2681,54.7,81,1.7,87,1.8,64,1.3,23,0.5,2051,41.9
E02001696,7383,100,3978,53.9,3736,50.6,242,3.3,110,1.5,69,0.9,41,0.6,3295,44.6
E02001697,6213,100,3822,61.5,3703,59.6,119,1.9,96,1.5,74,1.2,22,0.4,2295,36.9
E02001698,5974,100,2880,48.2,2792,46.7,88,1.5,97,1.6,71,1.2,26,0.4,2997,50.2
E02001699,5448,100,2884,52.9,2727,50.1,157,2.9,73,1.3,51,0.9,22,0.4,2491,45.7
E02001700,8462,100,4899,57.9,4729,55.9,170,2,154,1.8,107,1.3,47,0.6,3409,40.3
E02001701,5269,100,2959,56.2,2860,54.3,99,1.9,96,1.8,64,1.2,32,0.6,2214,42
E02001702,6210,100,3142,50.6,2877,46.3,265,4.3,109,1.8,68,1.1,41,0.7,2959,47.6
E02001703,4710,100,2458,52.2,2347,49.8,111,2.4,68,1.4,51,1.1,17,0.4,2184,46.4
E02001704,5683,100,3045,53.6,2840,50,205,3.6,104,1.8,63,1.1,41,0.7,2534,44.6
E02001706,6251,100,3680,58.9,3506,56.1,174,2.8,76,1.2,66,1.1,10,0.2,2495,39.9
E02001707,6922,100,3690,53.3,3501,50.6,189,2.7,88,1.3,64,0.9,24,0.3,3144,45.4
E02006841,6836,100,3836,56.1,3581,52.4,255,3.7,450,6.6,272,4,178,2.6,2550,37.3
E02006842,4032,100,2260,56.1,2099,52.1,161,4,112,2.8,93,2.3,19,0.5,1660,41.2
E02007094,5749,100,3064,53.3,2875,50,189,3.3,60,1,35,0.6,25,0.4,2625,45.7
E02002574,7146,100,4480,62.7,4388,61.4,92,1.3,142,2,109,1.5,33,0.5,2524,35.3
E02002575,7804,100,4948,63.4,4806,61.6,142,1.8,194,2.5,149,1.9,45,0.6,2662,34.1
E02002576,6162,100,3533,57.3,3382,54.9,151,2.5,113,1.8,89,1.4,24,0.4,2516,40.8
E02002577,5744,100,3033,52.8,2828,49.2,205,3.6,105,1.8,79,1.4,26,0.5,2606,45.4
E02002578,6721,100,4055,60.3,3905,58.1,150,2.2,147,2.2,112,1.7,35,0.5,2519,37.5
E02002579,6212,100,3439,55.4,3261,52.5,178,2.9,122,2,86,1.4,36,0.6,2651,42.7
E02002580,6224,100,3636,58.4,3366,54.1,270,4.3,113,1.8,78,1.3,35,0.6,2475,39.8
E02002581,5988,100,3313,55.3,3188,53.2,125,2.1,96,1.6,71,1.2,25,0.4,2579,43.1
E02002582,7652,100,5058,66.1,4922,64.3,136,1.8,169,2.2,129,1.7,40,0.5,2425,31.7
E02002583,5873,100,2945,50.1,2716,46.2,229,3.9,91,1.5,54,0.9,37,0.6,2837,48.3
E02002584,5931,100,3441,58,3297,55.6,144,2.4,132,2.2,89,1.5,43,0.7,2358,39.8
E02002585,8817,100,5529,62.7,5254,59.6,275,3.1,147,1.7,116,1.3,31,0.4,3141,35.6
E02002586,7459,100,3920,52.6,3639,48.8,281,3.8,118,1.6,87,1.2,31,0.4,3421,45.9
E02002587,5147,100,2840,55.2,2673,51.9,167,3.2,70,1.4,53,1,17,0.3,2237,43.5
E02002588,5743,100,2992,52.1,2783,48.5,209,3.6,93,1.6,61,1.1,32,0.6,2658,46.3
E02002589,5331,100,2957,55.5,2878,54,79,1.5,78,1.5,61,1.1,17,0.3,2296,43.1
E02002590,6239,100,3212,51.5,3081,49.4,131,2.1,114,1.8,82,1.3,32,0.5,2913,46.7
E02002591,5392,100,3068,56.9,2972,55.1,96,1.8,73,1.4,55,1,18,0.3,2251,41.7
E02002592,5238,100,2874,54.9,2772,52.9,102,1.9,101,1.9,82,1.6,19,0.4,2263,43.2
E02002593,4237,100,2386,56.3,2283,53.9,103,2.4,76,1.8,63,1.5,13,0.3,1775,41.9
E02002594,4547,100,2789,61.3,2637,58,152,3.3,93,2,81,1.8,12,0.3,1665,36.6
E02002595,6243,100,3770,60.4,3550,56.9,220,3.5,133,2.1,95,1.5,38,0.6,2340,37.5
E02002596,6825,100,3820,56,3637,53.3,183,2.7,159,2.3,117,1.7,42,0.6,2846,41.7
E02002597,7119,100,4100,57.6,3843,54,257,3.6,148,2.1,121,1.7,27,0.4,2871,40.3
E02002598,8725,100,6334,72.6,6187,70.9,147,1.7,209,2.4,169,1.9,40,0.5,2182,25
E02002599,8998,100,5700,63.3,5536,61.5,164,1.8,168,1.9,133,1.5,35,0.4,3130,34.8
E02002600,7538,100,4780,63.4,4535,60.2,245,3.3,119,1.6,90,1.2,29,0.4,2639,35
E02002601,7442,100,4633,62.3,4500,60.5,133,1.8,137,1.8,100,1.3,37,0.5,2672,35.9
E02002602,6263,100,3987,63.7,3762,60.1,225,3.6,128,2,103,1.6,25,0.4,2148,34.3
E02002603,5840,100,3350,57.4,3250,55.7,100,1.7,102,1.7,84,1.4,18,0.3,2388,40.9
E02002604,6508,100,3889,59.8,3775,58,114,1.8,117,1.8,92,1.4,25,0.4,2502,38.4
E02002605,7271,100,4548,62.5,4386,60.3,162,2.2,167,2.3,126,1.7,41,0.6,2556,35.2
E02002606,9303,100,6163,66.2,5879,63.2,284,3.1,189,2,151,1.6,38,0.4,2951,31.7
E02002607,9520,100,6064,63.7,5756,60.5,308,3.2,174,1.8,137,1.4,37,0.4,3282,34.5
E02002608,7046,100,3823,54.3,3724,52.9,99,1.4,142,2,108,1.5,34,0.5,3081,43.7
E02002609,7633,100,5004,65.6,4758,62.3,246,3.2,152,2,111,1.5,41,0.5,2477,32.5
E02002610,10147,100,6016,59.3,5850,57.7,166,1.6,149,1.5,112,1.1,37,0.4,3982,39.2
E02002611,6430,100,3876,60.3,3779,58.8,97,1.5,127,2,93,1.4,34,0.5,2427,37.7
E02002612,7555,100,4527,59.9,4414,58.4,113,1.5,126,1.7,94,1.2,32,0.4,2902,38.4
E02002613,5744,100,3437,59.8,3321,57.8,116,2,99,1.7,75,1.3,24,0.4,2208,38.4
E02002614,4921,100,2548,51.8,2475,50.3,73,1.5,79,1.6,61,1.2,18,0.4,2294,46.6
E02002615,8253,100,4542,55,4312,52.2,230,2.8,212,2.6,140,1.7,72,0.9,3499,42.4
E02002616,7074,100,3950,55.8,3753,53.1,197,2.8,172,2.4,138,2,34,0.5,2952,41.7
E02002617,7061,100,3415,48.4,3112,44.1,303,4.3,221,3.1,145,2.1,76,1.1,3425,48.5
E02002618,5915,100,2876,48.6,2666,45.1,210,3.6,179,3,128,2.2,51,0.9,2860,48.4
E02002619,6988,100,3462,49.5,3199,45.8,263,3.8,174,2.5,115,1.6,59,0.8,3352,48
E02002620,6947,100,3139,45.2,2858,41.1,281,4,201,2.9,143,2.1,58,0.8,3607,51.9
E02002621,6313,100,2991,47.4,2715,43,276,4.4,188,3,122,1.9,66,1,3134,49.6
E02002622,7959,100,4023,50.5,3710,46.6,313,3.9,185,2.3,148,1.9,37,0.5,3751,47.1
E02002623,8036,100,4521,56.3,4202,52.3,319,4,190,2.4,142,1.8,48,0.6,3325,41.4
E02002624,7266,100,4164,57.3,4050,55.7,114,1.6,122,1.7,98,1.3,24,0.3,2980,41
E02002625,7673,100,4501,58.7,4235,55.2,266,3.5,164,2.1,133,1.7,31,0.4,3008,39.2
E02002626,5799,100,3126,53.9,2950,50.9,176,3,107,1.8,83,1.4,24,0.4,2566,44.2
E02002627,5944,100,4083,68.7,3975,66.9,108,1.8,133,2.2,107,1.8,26,0.4,1728,29.1
E02002628,5638,100,3193,56.6,3009,53.4,184,3.3,108,1.9,82,1.5,26,0.5,2337,41.5
E02002629,4715,100,2637,55.9,2452,52,185,3.9,95,2,61,1.3,34,0.7,1983,42.1
E02002630,5138,100,2928,57,2767,53.9,161,3.1,97,1.9,80,1.6,17,0.3,2113,41.1
E02002631,7455,100,4559,61.2,4408,59.1,151,2,129,1.7,104,1.4,25,0.3,2767,37.1
E02002632,5338,100,3240,60.7,3146,58.9,94,1.8,89,1.7,76,1.4,13,0.2,2009,37.6
E02002633,6514,100,3210,49.3,3077,47.2,133,2,136,2.1,95,1.5,41,0.6,3168,48.6
E02002634,6906,100,3341,48.4,3167,45.9,174,2.5,148,2.1,100,1.4,48,0.7,3417,49.5
E02002635,6672,100,3391,50.8,3220,48.3,171,2.6,126,1.9,100,1.5,26,0.4,3155,47.3
E02002636,6591,100,3735,56.7,3548,53.8,187,2.8,155,2.4,132,2,23,0.3,2701,41
E02002637,5155,100,2995,58.1,2850,55.3,145,2.8,97,1.9,77,1.5,20,0.4,2063,40
E02002638,5529,100,2725,49.3,2358,42.6,367,6.6,80,1.4,56,1,24,0.4,2724,49.3
E02002639,4666,100,2294,49.2,2050,43.9,244,5.2,101,2.2,77,1.7,24,0.5,2271,48.7
E02002640,5495,100,2802,51,2440,44.4,362,6.6,113,2.1,81,1.5,32,0.6,2580,47
E02002641,6636,100,3957,59.6,3755,56.6,202,3,130,2,102,1.5,28,0.4,2549,38.4
E02002642,5837,100,2873,49.2,2480,42.5,393,6.7,93,1.6,66,1.1,27,0.5,2871,49.2
E02002643,6121,100,3348,54.7,3047,49.8,301,4.9,145,2.4,110,1.8,35,0.6,2628,42.9
E02002644,6486,100,3852,59.4,3687,56.8,165,2.5,140,2.2,105,1.6,35,0.5,2494,38.5
E02002645,5234,100,2747,52.5,2402,45.9,345,6.6,102,1.9,74,1.4,28,0.5,2385,45.6
E02002646,5850,100,2995,51.2,2817,48.2,178,3,109,1.9,84,1.4,25,0.4,2746,46.9
E02002647,6397,100,3528,55.2,3249,50.8,279,4.4,141,2.2,105,1.6,36,0.6,2728,42.6
E02002648,5629,100,3103,55.1,2898,51.5,205,3.6,114,2,96,1.7,18,0.3,2412,42.8
E02002649,7001,100,3832,54.7,3561,50.9,271,3.9,174,2.5,143,2,31,0.4,2995,42.8
E02002650,7035,100,3770,53.6,3605,51.2,165,2.3,137,1.9,112,1.6,25,0.4,3128,44.5
E02002651,6586,100,3472,52.7,3330,50.6,142,2.2,141,2.1,103,1.6,38,0.6,2973,45.1
E02003811,6287,100,3679,58.5,3591,57.1,88,1.4,90,1.4,74,1.2,16,0.3,2518,40.1
E02003812,5459,100,2949,54,2874,52.6,75,1.4,93,1.7,79,1.4,14,0.3,2417,44.3
E02003813,5234,100,2970,56.7,2847,54.4,123,2.4,82,1.6,68,1.3,14,0.3,2182,41.7
E02003814,6703,100,4448,66.4,4304,64.2,144,2.1,123,1.8,117,1.7,6,0.1,2132,31.8
E02003815,5971,100,3469,58.1,3324,55.7,145,2.4,65,1.1,51,0.9,14,0.2,2437,40.8
E02003816,6344,100,3831,60.4,3697,58.3,134,2.1,82,1.3,61,1,21,0.3,2431,38.3
E02003817,6419,100,3641,56.7,3548,55.3,93,1.4,80,1.2,68,1.1,12,0.2,2698,42
E02003818,4868,100,2779,57.1,2716,55.8,63,1.3,57,1.2,42,0.9,15,0.3,2032,41.7
E02003819,5573,100,3037,54.5,2956,53,81,1.5,65,1.2,57,1,8,0.1,2471,44.3
E02003820,7752,100,5351,69,5207,67.2,144,1.9,112,1.4,101,1.3,11,0.1,2289,29.5
E02003821,4753,100,2663,56,2573,54.1,90,1.9,55,1.2,40,0.8,15,0.3,2035,42.8
E02003822,9813,100,5653,57.6,5513,56.2,140,1.4,123,1.3,101,1,22,0.2,4037,41.1
E02003823,5717,100,2951,51.6,2844,49.7,107,1.9,93,1.6,71,1.2,22,0.4,2673,46.8
E02003824,5243,100,3101,59.1,3028,57.8,73,1.4,99,1.9,83,1.6,16,0.3,2043,39
E02003825,5194,100,3618,69.7,3506,67.5,112,2.2,131,2.5,111,2.1,20,0.4,1445,27.8
E02003826,6899,100,4258,61.7,4002,58,256,3.7,126,1.8,75,1.1,51,0.7,2515,36.5
E02003827,7544,100,4602,61,4303,57,299,4,104,1.4,87,1.2,17,0.2,2838,37.6
E02003828,5034,100,3079,61.2,2929,58.2,150,3,64,1.3,48,1,16,0.3,1891,37.6
E02003829,4886,100,2694,55.1,2601,53.2,93,1.9,53,1.1,49,1,4,0.1,2139,43.8
E02003830,6402,100,4073,63.6,3803,59.4,270,4.2,109,1.7,84,1.3,25,0.4,2220,34.7
E02003831,8490,100,5070,59.7,4935,58.1,135,1.6,154,1.8,133,1.6,21,0.2,3266,38.5
E02003832,5482,100,3697,67.4,3469,63.3,228,4.2,120,2.2,103,1.9,17,0.3,1665,30.4
E02003833,5127,100,3132,61.1,3034,59.2,98,1.9,109,2.1,74,1.4,35,0.7,1886,36.8
E02003834,5725,100,3822,66.8,3651,63.8,171,3,118,2.1,101,1.8,17,0.3,1785,31.2
E02003835,7093,100,3892,54.9,3806,53.7,86,1.2,129,1.8,108,1.5,21,0.3,3072,43.3
E02003836,6047,100,3186,52.7,3053,50.5,133,2.2,85,1.4,64,1.1,21,0.3,2776,45.9
E02003838,6695,100,4123,61.6,4014,60,109,1.6,97,1.4,81,1.2,16,0.2,2475,37
E02003839,6060,100,3181,52.5,3061,50.5,120,2,82,1.4,70,1.2,12,0.2,2797,46.2
E02003840,9210,100,4969,54,4846,52.6,123,1.3,132,1.4,114,1.2,18,0.2,4109,44.6
E02003853,5145,100,3058,59.4,2969,57.7,89,1.7,68,1.3,51,1,17,0.3,2019,39.2
E02003854,5265,100,2947,56,2866,54.4,81,1.5,99,1.9,86,1.6,13,0.2,2219,42.1
E02003855,5404,100,2805,51.9,2733,50.6,72,1.3,91,1.7,73,1.4,18,0.3,2508,46.4
E02003856,9284,100,5792,62.4,5524,59.5,268,2.9,101,1.1,78,0.8,23,0.2,3391,36.5
E02003857,5438,100,3468,63.8,3340,61.4,128,2.4,88,1.6,77,1.4,11,0.2,1882,34.6
E02003858,5743,100,3286,57.2,3178,55.3,108,1.9,72,1.3,59,1,13,0.2,2385,41.5
E02003859,10508,100,5837,55.5,5684,54.1,153,1.5,87,0.8,58,0.6,29,0.3,4584,43.6
E02003860,5720,100,3482,60.9,3389,59.2,93,1.6,82,1.4,68,1.2,14,0.2,2156,37.7
E02003861,5193,100,3002,57.8,2866,55.2,136,2.6,80,1.5,68,1.3,12,0.2,2111,40.7
E02003862,4501,100,2245,49.9,2181,48.5,64,1.4,45,1,36,0.8,9,0.2,2211,49.1
E02003863,5579,100,3121,55.9,3043,54.5,78,1.4,88,1.6,68,1.2,20,0.4,2370,42.5
E02003864,7341,100,3955,53.9,3845,52.4,110,1.5,81,1.1,63,0.9,18,0.2,3305,45
E02003865,6569,100,4058,61.8,3950,60.1,108,1.6,65,1,51,0.8,14,0.2,2446,37.2
E02003866,5184,100,3047,58.8,2957,57,90,1.7,89,1.7,79,1.5,10,0.2,2048,39.5
E02003867,6168,100,3739,60.6,3611,58.5,128,2.1,93,1.5,83,1.3,10,0.2,2336,37.9
E02003868,6947,100,4280,61.6,4077,58.7,203,2.9,116,1.7,93,1.3,23,0.3,2551,36.7
E02003869,6153,100,3660,59.5,3529,57.4,131,2.1,96,1.6,78,1.3,18,0.3,2397,39
E02003870,8938,100,6097,68.2,5803,64.9,294,3.3,134,1.5,100,1.1,34,0.4,2707,30.3
E02003871,5601,100,3216,57.4,3074,54.9,142,2.5,86,1.5,66,1.2,20,0.4,2299,41
E02003872,8754,100,4905,56,4798,54.8,107,1.2,103,1.2,81,0.9,22,0.3,3746,42.8
E02003873,4985,100,3105,62.3,2944,59.1,161,3.2,69,1.4,53,1.1,16,0.3,1811,36.3
E02007030,6144,100,3721,60.6,3621,58.9,100,1.6,247,4,180,2.9,67,1.1,2176,35.4
E02007031,6919,100,4524,65.4,4424,63.9,100,1.4,136,2,106,1.5,30,0.4,2259,32.6
E02003794,7149,100,4160,58.2,4041,56.5,119,1.7,120,1.7,90,1.3,30,0.4,2869,40.1
E02003795,5359,100,3044,56.8,2954,55.1,90,1.7,71,1.3,59,1.1,12,0.2,2244,41.9
E02003796,5974,100,3166,53,3031,50.7,135,2.3,73,1.2,54,0.9,19,0.3,2735,45.8
E02003797,8346,100,5015,60.1,4813,57.7,202,2.4,211,2.5,172,2.1,39,0.5,3120,37.4
E02003798,4892,100,2763,56.5,2569,52.5,194,4,93,1.9,65,1.3,28,0.6,2036,41.6
E02003799,5801,100,3275,56.5,3052,52.6,223,3.8,102,1.8,77,1.3,25,0.4,2424,41.8
E02003800,5864,100,3311,56.5,3214,54.8,97,1.7,73,1.2,59,1,14,0.2,2480,42.3
E02003801,5770,100,3419,59.3,3313,57.4,106,1.8,106,1.8,75,1.3,31,0.5,2245,38.9
E02003802,7833,100,4641,59.2,4435,56.6,206,2.6,404,5.2,306,3.9,98,1.3,2788,35.6
E02003803,9641,100,4235,43.9,4008,41.6,227,2.4,1265,13.1,900,9.3,365,3.8,4141,43
E02003804,5796,100,3760,64.9,3592,62,168,2.9,98,1.7,77,1.3,21,0.4,1938,33.4
E02003805,5247,100,2890,55.1,2808,53.5,82,1.6,67,1.3,49,0.9,18,0.3,2290,43.6
E02003806,6540,100,4111,62.9,3998,61.1,113,1.7,106,1.6,84,1.3,22,0.3,2323,35.5
E02003807,7551,100,3947,52.3,3766,49.9,181,2.4,102,1.4,65,0.9,37,0.5,3502,46.4
E02003808,5159,100,3170,61.4,2997,58.1,173,3.4,92,1.8,71,1.4,21,0.4,1897,36.8
E02003809,6923,100,3978,57.5,3874,56,104,1.5,95,1.4,72,1,23,0.3,2850,41.2
E02003810,8074,100,4719,58.4,4586,56.8,133,1.6,152,1.9,120,1.5,32,0.4,3203,39.7
E02003841,6701,100,3375,50.4,3198,47.7,177,2.6,89,1.3,69,1,20,0.3,3237,48.3
E02003842,4849,100,2454,50.6,2394,49.4,60,1.2,53,1.1,42,0.9,11,0.2,2342,48.3
E02003843,5392,100,3055,56.7,2885,53.5,170,3.2,71,1.3,56,1,15,0.3,2266,42
E02003844,5683,100,2876,50.6,2798,49.2,78,1.4,106,1.9,88,1.5,18,0.3,2701,47.5
E02003845,8655,100,5507,63.6,5180,59.8,327,3.8,165,1.9,135,1.6,30,0.3,2983,34.5
E02003846,5305,100,3144,59.3,2948,55.6,196,3.7,109,2.1,89,1.7,20,0.4,2052,38.7
E02003847,8276,100,5112,61.8,4976,60.1,136,1.6,145,1.8,102,1.2,43,0.5,3019,36.5
E02003848,4249,100,2479,58.3,2368,55.7,111,2.6,82,1.9,71,1.7,11,0.3,1688,39.7
E02003849,6584,100,3879,58.9,3652,55.5,227,3.4,132,2,115,1.7,17,0.3,2573,39.1
E02003850,4255,100,2412,56.7,2319,54.5,93,2.2,63,1.5,47,1.1,16,0.4,1780,41.8
E02003851,4872,100,2850,58.5,2770,56.9,80,1.6,106,2.2,83,1.7,23,0.5,1916,39.3
E02003852,5491,100,3167,57.7,3069,55.9,98,1.8,95,1.7,85,1.5,10,0.2,2229,40.6
E02003874,7683,100,4245,55.3,4111,53.5,134,1.7,141,1.8,116,1.5,25,0.3,3297,42.9
E02003875,5564,100,3070,55.2,2995,53.8,75,1.3,64,1.2,45,0.8,19,0.3,2430,43.7
E02003876,4604,100,2740,59.5,2647,57.5,93,2,83,1.8,60,1.3,23,0.5,1781,38.7
E02003877,8177,100,4598,56.2,4460,54.5,138,1.7,100,1.2,74,0.9,26,0.3,3479,42.5
E02003878,7734,100,4597,59.4,4456,57.6,141,1.8,90,1.2,70,0.9,20,0.3,3047,39.4
E02003879,7343,100,5167,70.4,4986,67.9,181,2.5,109,1.5,84,1.1,25,0.3,2067,28.1
E02003880,5414,100,3072,56.7,2944,54.4,128,2.4,68,1.3,53,1,15,0.3,2274,42
E02003881,4805,100,3030,63.1,2917,60.7,113,2.4,65,1.4,45,0.9,20,0.4,1710,35.6
E02003882,7677,100,4632,60.3,4465,58.2,167,2.2,134,1.7,95,1.2,39,0.5,2911,37.9
E02003883,9244,100,5603,60.6,5401,58.4,202,2.2,183,2,141,1.5,42,0.5,3458,37.4
E02003884,7395,100,4090,55.3,3976,53.8,114,1.5,102,1.4,80,1.1,22,0.3,3203,43.3
E02003885,5316,100,3162,59.5,3074,57.8,88,1.7,69,1.3,58,1.1,11,0.2,2085,39.2
E02003886,5242,100,3232,61.7,3086,58.9,146,2.8,87,1.7,70,1.3,17,0.3,1923,36.7
E02003887,5636,100,3624,64.3,3486,61.9,138,2.4,72,1.3,62,1.1,10,0.2,1940,34.4
E02003888,5300,100,3152,59.5,3000,56.6,152,2.9,60,1.1,41,0.8,19,0.4,2088,39.4
E02003889,4941,100,2745,55.6,2601,52.6,144,2.9,77,1.6,55,1.1,22,0.4,2119,42.9
E02003890,5680,100,3490,61.4,3364,59.2,126,2.2,76,1.3,57,1,19,0.3,2114,37.2
E02003891,5371,100,2968,55.3,2882,53.7,86,1.6,73,1.4,47,0.9,26,0.5,2330,43.4
E02003965,9309,100,5048,54.2,4871,52.3,177,1.9,120,1.3,95,1,25,0.3,4141,44.5
E02003966,6029,100,3501,58.1,3422,56.8,79,1.3,67,1.1,53,0.9,14,0.2,2461,40.8
E02003967,6737,100,3824,56.8,3700,54.9,124,1.8,50,0.7,42,0.6,8,0.1,2863,42.5
E02003968,7457,100,4175,56,4032,54.1,143,1.9,92,1.2,76,1,16,0.2,3190,42.8
E02003969,5252,100,2879,54.8,2739,52.2,140,2.7,60,1.1,53,1,7,0.1,2313,44
E02003970,6946,100,3994,57.5,3895,56.1,99,1.4,80,1.2,65,0.9,15,0.2,2872,41.3
E02003971,6617,100,3569,53.9,3472,52.5,97,1.5,72,1.1,54,0.8,18,0.3,2976,45
E02003972,7464,100,4352,58.3,4166,55.8,186,2.5,68,0.9,54,0.7,14,0.2,3044,40.8
E02003973,6972,100,3816,54.7,3575,51.3,241,3.5,89,1.3,68,1,21,0.3,3067,44
E02003974,6222,100,3454,55.5,3310,53.2,144,2.3,56,0.9,42,0.7,14,0.2,2712,43.6
E02003975,6011,100,3516,58.5,3424,57,92,1.5,80,1.3,67,1.1,13,0.2,2415,40.2
E02003976,5501,100,2977,54.1,2904,52.8,73,1.3,82,1.5,61,1.1,21,0.4,2442,44.4
E02003977,5222,100,3225,61.8,3130,59.9,95,1.8,91,1.7,70,1.3,21,0.4,1906,36.5
E02003978,4869,100,2827,58.1,2735,56.2,92,1.9,78,1.6,52,1.1,26,0.5,1964,40.3
E02003979,6692,100,3454,51.6,3398,50.8,56,0.8,91,1.4,70,1,21,0.3,3147,47
E02003980,5390,100,2939,54.5,2754,51.1,185,3.4,78,1.4,56,1,22,0.4,2373,44
E02003981,5396,100,3459,64.1,3340,61.9,119,2.2,77,1.4,66,1.2,11,0.2,1860,34.5
E02003982,6564,100,3887,59.2,3774,57.5,113,1.7,86,1.3,67,1,19,0.3,2591,39.5
E02003983,5848,100,3341,57.1,3169,54.2,172,2.9,104,1.8,78,1.3,26,0.4,2403,41.1
E02003984,5183,100,2784,53.7,2553,49.3,231,4.5,60,1.2,48,0.9,12,0.2,2339,45.1
E02003985,5589,100,3102,55.5,3010,53.9,92,1.6,88,1.6,68,1.2,20,0.4,2399,42.9
E02003986,5082,100,2842,55.9,2700,53.1,142,2.8,82,1.6,51,1,31,0.6,2158,42.5
E02003987,5099,100,3022,59.3,2921,57.3,101,2,67,1.3,54,1.1,13,0.3,2010,39.4
E02003988,5548,100,3036,54.7,2923,52.7,113,2,75,1.4,50,0.9,25,0.5,2437,43.9
E02003989,6311,100,3578,56.7,3481,55.2,97,1.5,99,1.6,70,1.1,29,0.5,2634,41.7
E02003990,9031,100,5354,59.3,5232,57.9,122,1.4,185,2,140,1.6,45,0.5,3492,38.7
E02003991,6400,100,3676,57.4,3623,56.6,53,0.8,112,1.8,88,1.4,24,0.4,2612,40.8
E02003992,7055,100,4097,58.1,3880,55,217,3.1,240,3.4,184,2.6,56,0.8,2718,38.5
E02003993,7533,100,4207,55.8,4120,54.7,87,1.2,96,1.3,85,1.1,11,0.1,3230,42.9
E02003994,6043,100,3596,59.5,3425,56.7,171,2.8,101,1.7,75,1.2,26,0.4,2346,38.8
E02003995,8086,100,4725,58.4,4478,55.4,247,3.1,130,1.6,98,1.2,32,0.4,3231,40
E02003996,7953,100,5150,64.8,4962,62.4,188,2.4,244,3.1,152,1.9,92,1.2,2559,32.2
E02003997,7372,100,4291,58.2,4075,55.3,216,2.9,132,1.8,99,1.3,33,0.4,2949,40
E02003998,5135,100,2938,57.2,2773,54,165,3.2,78,1.5,56,1.1,22,0.4,2119,41.3
E02003999,9772,100,5864,60,5759,58.9,105,1.1,167,1.7,139,1.4,28,0.3,3741,38.3
E02004000,4323,100,2411,55.8,2287,52.9,124,2.9,50,1.2,39,0.9,11,0.3,1862,43.1
E02004001,4502,100,2446,54.3,2313,51.4,133,3,56,1.2,47,1,9,0.2,2000,44.4
E02004002,7983,100,4635,58.1,4515,56.6,120,1.5,113,1.4,86,1.1,27,0.3,3235,40.5
E02004003,9690,100,5525,57,5310,54.8,215,2.2,95,1,73,0.8,22,0.2,4070,42
E02004004,7794,100,4470,57.4,4249,54.5,221,2.8,83,1.1,64,0.8,19,0.2,3241,41.6
E02004005,6341,100,3527,55.6,3381,53.3,146,2.3,80,1.3,63,1,17,0.3,2734,43.1
E02004006,7154,100,3883,54.3,3780,52.8,103,1.4,90,1.3,68,1,22,0.3,3181,44.5
E02004007,8210,100,4402,53.6,4244,51.7,158,1.9,76,0.9,49,0.6,27,0.3,3732,45.5
E02004008,5491,100,3246,59.1,3168,57.7,78,1.4,71,1.3,65,1.2,6,0.1,2174,39.6
E02004009,5343,100,3203,59.9,3149,58.9,54,1,83,1.6,74,1.4,9,0.2,2057,38.5
E02004010,6452,100,3999,62,3823,59.3,176,2.7,88,1.4,75,1.2,13,0.2,2365,36.7
E02004011,9246,100,5411,58.5,5272,57,139,1.5,124,1.3,110,1.2,14,0.2,3711,40.1
E02004012,4775,100,2799,58.6,2730,57.2,69,1.4,69,1.4,62,1.3,7,0.1,1907,39.9
E02004013,8715,100,5092,58.4,4940,56.7,152,1.7,107,1.2,91,1,16,0.2,3516,40.3
E02004014,6607,100,3797,57.5,3697,56,100,1.5,92,1.4,77,1.2,15,0.2,2718,41.1
E02004015,5484,100,2968,54.1,2895,52.8,73,1.3,128,2.3,98,1.8,30,0.5,2388,43.5
E02004016,6935,100,4069,58.7,3940,56.8,129,1.9,135,1.9,116,1.7,19,0.3,2731,39.4
E02004017,7473,100,4569,61.1,4470,59.8,99,1.3,142,1.9,128,1.7,14,0.2,2762,37
E02004018,6918,100,4236,61.2,4081,59,155,2.2,124,1.8,111,1.6,13,0.2,2558,37
E02004019,6651,100,3794,57,3722,56,72,1.1,114,1.7,98,1.5,16,0.2,2743,41.2
E02004020,7572,100,4468,59,4364,57.6,104,1.4,155,2,134,1.8,21,0.3,2949,38.9
E02004021,4655,100,2640,56.7,2596,55.8,44,0.9,42,0.9,36,0.8,6,0.1,1973,42.4
E02004022,4796,100,2726,56.8,2662,55.5,64,1.3,51,1.1,42,0.9,9,0.2,2019,42.1
E02004023,5250,100,2718,51.8,2646,50.4,72,1.4,72,1.4,59,1.1,13,0.2,2460,46.9
E02004024,6377,100,3481,54.6,3437,53.9,44,0.7,95,1.5,79,1.2,16,0.3,2801,43.9
E02004025,6829,100,3461,50.7,3394,49.7,67,1,106,1.6,81,1.2,25,0.4,3262,47.8
E02004026,6836,100,4046,59.2,3906,57.1,140,2,92,1.3,75,1.1,17,0.2,2698,39.5
E02004027,7109,100,3389,47.7,3289,46.3,100,1.4,82,1.2,60,0.8,22,0.3,3638,51.2
E02004028,6815,100,3643,53.5,3550,52.1,93,1.4,82,1.2,62,0.9,20,0.3,3090,45.3
E02005176,7275,100,4169,57.3,3999,55,170,2.3,132,1.8,97,1.3,35,0.5,2974,40.9
E02005177,5233,100,2694,51.5,2526,48.3,168,3.2,70,1.3,49,0.9,21,0.4,2469,47.2
E02005178,8524,100,4254,49.9,3781,44.4,473,5.5,237,2.8,177,2.1,60,0.7,4033,47.3
E02005179,7405,100,4083,55.1,3820,51.6,263,3.6,136,1.8,117,1.6,19,0.3,3186,43
E02005180,5885,100,3362,57.1,3272,55.6,90,1.5,104,1.8,84,1.4,20,0.3,2419,41.1
E02005181,5341,100,3121,58.4,2956,55.3,165,3.1,101,1.9,76,1.4,25,0.5,2119,39.7
E02005182,4962,100,2574,51.9,2376,47.9,198,4,99,2,63,1.3,36,0.7,2289,46.1
E02005183,5023,100,2634,52.4,2506,49.9,128,2.5,82,1.6,57,1.1,25,0.5,2307,45.9
E02005184,4400,100,2427,55.2,2352,53.5,75,1.7,42,1,29,0.7,13,0.3,1931,43.9
E02005185,7440,100,4018,54,3736,50.2,282,3.8,158,2.1,136,1.8,22,0.3,3264,43.9
E02005186,5123,100,3187,62.2,3084,60.2,103,2,79,1.5,66,1.3,13,0.3,1857,36.2
E02006881,8583,100,4821,56.2,4557,53.1,264,3.1,142,1.7,116,1.4,26,0.3,3620,42.2
E02005189,4280,100,2470,57.7,2350,54.9,120,2.8,60,1.4,47,1.1,13,0.3,1750,40.9
E02005190,5106,100,3098,60.7,3024,59.2,74,1.4,84,1.6,60,1.2,24,0.5,1924,37.7
E02005191,7935,100,4864,61.3,4737,59.7,127,1.6,153,1.9,124,1.6,29,0.4,2918,36.8
E02005192,7126,100,4696,65.9,4565,64.1,131,1.8,173,2.4,142,2,31,0.4,2257,31.7
E02005193,7227,100,4235,58.6,4128,57.1,107,1.5,146,2,107,1.5,39,0.5,2846,39.4
E02005194,6605,100,3875,58.7,3743,56.7,132,2,108,1.6,88,1.3,20,0.3,2622,39.7
E02005195,6826,100,3355,49.2,3183,46.6,172,2.5,101,1.5,86,1.3,15,0.2,3370,49.4
E02005196,8932,100,5524,61.8,5362,60,162,1.8,175,2,130,1.5,45,0.5,3233,36.2
E02005197,5771,100,3430,59.4,3279,56.8,151,2.6,123,2.1,99,1.7,24,0.4,2218,38.4
E02005198,7831,100,4821,61.6,4620,59,201,2.6,151,1.9,124,1.6,27,0.3,2859,36.5
E02005199,6340,100,3670,57.9,3610,56.9,60,0.9,99,1.6,83,1.3,16,0.3,2571,40.6
E02005200,7199,100,4641,64.5,4468,62.1,173,2.4,137,1.9,102,1.4,35,0.5,2421,33.6
E02005201,6806,100,4097,60.2,3970,58.3,127,1.9,112,1.6,88,1.3,24,0.4,2597,38.2
E02005202,8371,100,4968,59.3,4815,57.5,153,1.8,139,1.7,109,1.3,30,0.4,3264,39
E02005203,7026,100,4173,59.4,4045,57.6,128,1.8,124,1.8,110,1.6,14,0.2,2729,38.8
E02005204,10358,100,6127,59.2,5943,57.4,184,1.8,198,1.9,161,1.6,37,0.4,4033,38.9
E02005205,5647,100,3030,53.7,2914,51.6,116,2.1,97,1.7,88,1.6,9,0.2,2520,44.6
E02005206,6283,100,3344,53.2,3188,50.7,156,2.5,102,1.6,73,1.2,29,0.5,2837,45.2
E02005207,7313,100,3468,47.4,3344,45.7,124,1.7,103,1.4,76,1,27,0.4,3742,51.2
E02005208,8895,100,4233,47.6,3955,44.5,278,3.1,140,1.6,114,1.3,26,0.3,4522,50.8
E02005209,7392,100,4097,55.4,3945,53.4,152,2.1,115,1.6,96,1.3,19,0.3,3180,43
E02005210,8908,100,4080,45.8,3963,44.5,117,1.3,127,1.4,98,1.1,29,0.3,4701,52.8
E02005211,7429,100,3667,49.4,3521,47.4,146,2,112,1.5,86,1.2,26,0.3,3650,49.1
E02005212,8993,100,4960,55.2,4740,52.7,220,2.4,179,2,124,1.4,55,0.6,3854,42.9
E02005213,9242,100,5480,59.3,5274,57.1,206,2.2,193,2.1,151,1.6,42,0.5,3569,38.6
E02005214,5466,100,3140,57.4,2979,54.5,161,2.9,94,1.7,73,1.3,21,0.4,2232,40.8
E02005215,10015,100,5537,55.3,5217,52.1,320,3.2,215,2.1,161,1.6,54,0.5,4263,42.6
E02005216,4239,100,2415,57,2270,53.6,145,3.4,71,1.7,52,1.2,19,0.4,1753,41.4
E02005217,9536,100,4644,48.7,4211,44.2,433,4.5,227,2.4,165,1.7,62,0.7,4665,48.9
E02005218,5931,100,3417,57.6,3278,55.3,139,2.3,96,1.6,75,1.3,21,0.4,2418,40.8
E02005219,7160,100,4176,58.3,3974,55.5,202,2.8,124,1.7,100,1.4,24,0.3,2860,39.9
E02005220,5046,100,2795,55.4,2716,53.8,79,1.6,78,1.5,64,1.3,14,0.3,2173,43.1
E02005221,8411,100,4569,54.3,4461,53,108,1.3,118,1.4,101,1.2,17,0.2,3724,44.3
E02005222,5126,100,2803,54.7,2748,53.6,55,1.1,84,1.6,67,1.3,17,0.3,2239,43.7
E02005223,6242,100,3274,52.5,3210,51.4,64,1,86,1.4,69,1.1,17,0.3,2882,46.2
E02005224,4573,100,1970,43.1,1888,41.3,82,1.8,58,1.3,41,0.9,17,0.4,2545,55.7
E02005225,4995,100,2919,58.4,2886,57.8,33,0.7,80,1.6,63,1.3,17,0.3,1996,40
E02005226,5947,100,3164,53.2,2914,49,250,4.2,101,1.7,69,1.2,32,0.5,2682,45.1
E02005228,4627,100,2792,60.3,2668,57.7,124,2.7,81,1.8,70,1.5,11,0.2,1754,37.9
E02005229,4637,100,2612,56.3,2403,51.8,209,4.5,84,1.8,57,1.2,27,0.6,1941,41.9
E02005230,5438,100,2661,48.9,2512,46.2,149,2.7,92,1.7,63,1.2,29,0.5,2685,49.4
E02005231,6657,100,3844,57.7,3656,54.9,188,2.8,134,2,103,1.5,31,0.5,2679,40.2
E02005233,6502,100,3835,59,3697,56.9,138,2.1,164,2.5,130,2,34,0.5,2503,38.5
E02005234,8190,100,2956,36.1,2806,34.3,150,1.8,812,9.9,607,7.4,205,2.5,4422,54
E02005235,4581,100,1975,43.1,1881,41.1,94,2.1,440,9.6,351,7.7,89,1.9,2166,47.3
E02005236,10874,100,6307,58,6094,56,213,2,162,1.5,131,1.2,31,0.3,4405,40.5
E02005237,8520,100,4744,55.7,4571,53.7,173,2,297,3.5,232,2.7,65,0.8,3479,40.8
E02005238,4550,100,2546,56,2477,54.4,69,1.5,134,2.9,103,2.3,31,0.7,1870,41.1
E02005239,9814,100,3210,32.7,3146,32.1,64,0.7,897,9.1,567,5.8,330,3.4,5707,58.2
E02006871,9969,100,5592,56.1,5410,54.3,182,1.8,190,1.9,155,1.6,35,0.4,4187,42
E02005240,4471,100,2686,60.1,2599,58.1,87,1.9,76,1.7,56,1.3,20,0.4,1709,38.2
E02005241,4654,100,2703,58.1,2598,55.8,105,2.3,54,1.2,44,0.9,10,0.2,1897,40.8
E02005242,5110,100,2996,58.6,2901,56.8,95,1.9,68,1.3,57,1.1,11,0.2,2046,40
E02005245,5798,100,3548,61.2,3468,59.8,80,1.4,87,1.5,75,1.3,12,0.2,2163,37.3
E02005246,4367,100,2454,56.2,2295,52.6,159,3.6,71,1.6,55,1.3,16,0.4,1842,42.2
E02005247,8320,100,4746,57,4619,55.5,127,1.5,120,1.4,102,1.2,18,0.2,3454,41.5
E02005248,5664,100,2639,46.6,2418,42.7,221,3.9,137,2.4,98,1.7,39,0.7,2888,51
E02005249,7791,100,3934,50.5,3596,46.2,338,4.3,152,2,117,1.5,35,0.4,3705,47.6
E02005250,6838,100,3248,47.5,2960,43.3,288,4.2,182,2.7,133,1.9,49,0.7,3408,49.8
E02005251,5614,100,2935,52.3,2797,49.8,138,2.5,114,2,82,1.5,32,0.6,2565,45.7
E02005252,7963,100,3880,48.7,3665,46,215,2.7,174,2.2,136,1.7,38,0.5,3909,49.1
E02007003,8626,100,4855,56.3,4625,53.6,230,2.7,149,1.7,124,1.4,25,0.3,3622,42
E02005253,5854,100,3543,60.5,3480,59.4,63,1.1,118,2,97,1.7,21,0.4,2193,37.5
E02005254,7685,100,4933,64.2,4870,63.4,63,0.8,185,2.4,149,1.9,36,0.5,2567,33.4
E02005255,7714,100,4432,57.5,4334,56.2,98,1.3,195,2.5,150,1.9,45,0.6,3087,40
E02005256,5630,100,3476,61.7,3409,60.6,67,1.2,113,2,96,1.7,17,0.3,2041,36.3
E02005257,4662,100,2410,51.7,2261,48.5,149,3.2,102,2.2,77,1.7,25,0.5,2150,46.1
E02005258,6821,100,3531,51.8,3441,50.4,90,1.3,217,3.2,163,2.4,54,0.8,3073,45.1
E02005259,8108,100,4625,57,4401,54.3,224,2.8,188,2.3,142,1.8,46,0.6,3295,40.6
E02005260,5531,100,3222,58.3,3114,56.3,108,2,120,2.2,100,1.8,20,0.4,2189,39.6
E02005261,7669,100,4301,56.1,4034,52.6,267,3.5,207,2.7,166,2.2,41,0.5,3161,41.2
E02005262,5978,100,3996,66.8,3899,65.2,97,1.6,168,2.8,131,2.2,37,0.6,1814,30.3
E02005263,5713,100,2945,51.5,2748,48.1,197,3.4,480,8.4,360,6.3,120,2.1,2288,40
E02005264,10509,100,5068,48.2,4804,45.7,264,2.5,1283,12.2,866,8.2,417,4,4158,39.6
E02005265,8679,100,5168,59.5,4937,56.9,231,2.7,202,2.3,154,1.8,48,0.6,3309,38.1
E02005266,6747,100,3676,54.5,3375,50,301,4.5,225,3.3,164,2.4,61,0.9,2846,42.2
E02005267,5315,100,1895,35.7,1741,32.8,154,2.9,674,12.7,402,7.6,272,5.1,2746,51.7
E02005268,7057,100,3925,55.6,3653,51.8,272,3.9,203,2.9,141,2,62,0.9,2929,41.5
E02005269,9011,100,4519,50.1,4165,46.2,354,3.9,853,9.5,619,6.9,234,2.6,3639,40.4
E02005270,6251,100,3598,57.6,3515,56.2,83,1.3,122,2,98,1.6,24,0.4,2531,40.5
E02005271,6754,100,4056,60.1,3946,58.4,110,1.6,101,1.5,88,1.3,13,0.2,2597,38.5
E02005272,7326,100,4480,61.2,4324,59,156,2.1,122,1.7,107,1.5,15,0.2,2724,37.2
E02005273,5038,100,2989,59.3,2953,58.6,36,0.7,69,1.4,56,1.1,13,0.3,1980,39.3
E02005274,6539,100,3993,61.1,3924,60,69,1.1,105,1.6,86,1.3,19,0.3,2441,37.3
E02005275,4765,100,2865,60.1,2783,58.4,82,1.7,74,1.6,60,1.3,14,0.3,1826,38.3
E02005276,7360,100,4420,60.1,4315,58.6,105,1.4,125,1.7,103,1.4,22,0.3,2815,38.2
E02005277,7435,100,4012,54,3925,52.8,87,1.2,122,1.6,107,1.4,15,0.2,3301,44.4
E02005278,6450,100,4078,63.2,3972,61.6,106,1.6,107,1.7,89,1.4,18,0.3,2265,35.1
E02005279,8184,100,4638,56.7,4402,53.8,236,2.9,157,1.9,130,1.6,27,0.3,3389,41.4
E02005280,8745,100,5246,60,5016,57.4,230,2.6,130,1.5,102,1.2,28,0.3,3369,38.5
E02005281,7136,100,4195,58.8,3998,56,197,2.8,119,1.7,100,1.4,19,0.3,2822,39.5
E02005284,5028,100,2889,57.5,2818,56,71,1.4,89,1.8,71,1.4,18,0.4,2050,40.8
E02005285,5275,100,3175,60.2,3081,58.4,94,1.8,74,1.4,57,1.1,17,0.3,2026,38.4
E02005286,6399,100,3763,58.8,3621,56.6,142,2.2,80,1.3,52,0.8,28,0.4,2556,39.9
E02006884,10084,100,5767,57.2,5469,54.2,298,3,169,1.7,134,1.3,35,0.3,4148,41.1
E02005287,4380,100,2584,59,2534,57.9,50,1.1,87,2,63,1.4,24,0.5,1709,39
E02005288,5069,100,2932,57.8,2841,56,91,1.8,85,1.7,67,1.3,18,0.4,2052,40.5
E02005289,4978,100,2712,54.5,2646,53.2,66,1.3,76,1.5,54,1.1,22,0.4,2190,44
E02005290,5940,100,3872,65.2,3770,63.5,102,1.7,140,2.4,112,1.9,28,0.5,1928,32.5
E02005291,4688,100,2851,60.8,2757,58.8,94,2,102,2.2,83,1.8,19,0.4,1735,37
E02005292,4543,100,2603,57.3,2521,55.5,82,1.8,85,1.9,60,1.3,25,0.6,1855,40.8
E02005293,4539,100,2589,57,2464,54.3,125,2.8,58,1.3,36,0.8,22,0.5,1892,41.7
E02005294,5672,100,3716,65.5,3575,63,141,2.5,102,1.8,81,1.4,21,0.4,1854,32.7
E02005295,6269,100,3943,62.9,3837,61.2,106,1.7,123,2,95,1.5,28,0.4,2203,35.1
E02005296,5065,100,2809,55.5,2732,53.9,77,1.5,100,2,84,1.7,16,0.3,2156,42.6
E02005297,7056,100,3941,55.9,3861,54.7,80,1.1,142,2,116,1.6,26,0.4,2973,42.1
E02005298,6819,100,4425,64.9,4319,63.3,106,1.6,136,2,110,1.6,26,0.4,2258,33.1
E02005299,6031,100,4039,67,3897,64.6,142,2.4,132,2.2,104,1.7,28,0.5,1860,30.8
E02005300,4135,100,2438,59,2366,57.2,72,1.7,76,1.8,61,1.5,15,0.4,1621,39.2
E02005301,5098,100,2882,56.5,2778,54.5,104,2,81,1.6,67,1.3,14,0.3,2135,41.9
E02005302,6213,100,3854,62,3753,60.4,101,1.6,134,2.2,104,1.7,30,0.5,2225,35.8
E02005303,5008,100,2824,56.4,2703,54,121,2.4,92,1.8,66,1.3,26,0.5,2092,41.8
E02005304,7571,100,4457,58.9,4337,57.3,120,1.6,141,1.9,109,1.4,32,0.4,2973,39.3
E02005305,6848,100,3747,54.7,3634,53.1,113,1.7,94,1.4,75,1.1,19,0.3,3007,43.9
E02005306,6453,100,3577,55.4,3477,53.9,100,1.5,103,1.6,88,1.4,15,0.2,2773,43
E02005307,7921,100,4712,59.5,4571,57.7,141,1.8,167,2.1,130,1.6,37,0.5,3042,38.4
E02005308,5539,100,3056,55.2,2979,53.8,77,1.4,110,2,85,1.5,25,0.5,2373,42.8
E02005309,7373,100,4050,54.9,3942,53.5,108,1.5,263,3.6,214,2.9,49,0.7,3060,41.5
E02005310,9211,100,2966,32.2,2869,31.1,97,1.1,1288,14,899,9.8,389,4.2,4957,53.8
E02005311,6043,100,2656,44,2572,42.6,84,1.4,477,7.9,276,4.6,201,3.3,2910,48.2
E02005312,5301,100,3285,62,3188,60.1,97,1.8,136,2.6,107,2,29,0.5,1880,35.5
E02005313,6874,100,3938,57.3,3698,53.8,240,3.5,152,2.2,127,1.8,25,0.4,2784,40.5
E02005314,5326,100,3135,58.9,2977,55.9,158,3,98,1.8,62,1.2,36,0.7,2093,39.3
E02005315,6783,100,3528,52,3422,50.4,106,1.6,109,1.6,89,1.3,20,0.3,3146,46.4
E02005316,5103,100,3085,60.5,2887,56.6,198,3.9,87,1.7,62,1.2,25,0.5,1931,37.8
E02005317,5646,100,3257,57.7,2995,53,262,4.6,109,1.9,87,1.5,22,0.4,2280,40.4
E02005318,6333,100,3627,57.3,3502,55.3,125,2,104,1.6,84,1.3,20,0.3,2602,41.1
E02005319,6775,100,3443,50.8,3107,45.9,336,5,106,1.6,82,1.2,24,0.4,3226,47.6
E02005320,4736,100,2501,52.8,2359,49.8,142,3,89,1.9,55,1.2,34,0.7,2146,45.3
E02005321,5061,100,2130,42.1,1963,38.8,167,3.3,58,1.1,40,0.8,18,0.4,2873,56.8
E02005322,8901,100,4149,46.6,4012,45.1,137,1.5,103,1.2,83,0.9,20,0.2,4649,52.2
E02005323,6067,100,3197,52.7,3015,49.7,182,3,110,1.8,74,1.2,36,0.6,2760,45.5
E02005324,6155,100,3385,55,3297,53.6,88,1.4,187,3,137,2.2,50,0.8,2583,42
E02005325,8011,100,4056,50.6,3979,49.7,77,1,147,1.8,119,1.5,28,0.3,3808,47.5
E02005326,7213,100,3392,47,3163,43.9,229,3.2,107,1.5,74,1,33,0.5,3714,51.5
E02005327,5607,100,3244,57.9,3162,56.4,82,1.5,91,1.6,66,1.2,25,0.4,2272,40.5
E02005328,6571,100,3225,49.1,3122,47.5,103,1.6,115,1.8,96,1.5,19,0.3,3231,49.2
E02005329,7600,100,4393,57.8,4224,55.6,169,2.2,142,1.9,127,1.7,15,0.2,3065,40.3
E02005330,7510,100,3914,52.1,3799,50.6,115,1.5,132,1.8,104,1.4,28,0.4,3464,46.1
E02005331,7022,100,3759,53.5,3625,51.6,134,1.9,143,2,112,1.6,31,0.4,3120,44.4
E02005332,7121,100,3851,54.1,3724,52.3,127,1.8,135,1.9,114,1.6,21,0.3,3135,44
E02000984,6376,100,3916,61.4,3792,59.5,124,1.9,138,2.2,104,1.6,34,0.5,2322,36.4
E02000985,6211,100,3436,55.3,3326,53.6,110,1.8,115,1.9,90,1.4,25,0.4,2660,42.8
E02000986,6882,100,4102,59.6,3964,57.6,138,2,130,1.9,114,1.7,16,0.2,2650,38.5
E02000987,6131,100,3555,58,3376,55.1,179,2.9,98,1.6,77,1.3,21,0.3,2478,40.4
E02000988,7145,100,3901,54.6,3687,51.6,214,3,177,2.5,130,1.8,47,0.7,3067,42.9
E02000989,7074,100,3783,53.5,3683,52.1,100,1.4,125,1.8,89,1.3,36,0.5,3166,44.8
E02000990,6921,100,4356,62.9,4211,60.8,145,2.1,97,1.4,74,1.1,23,0.3,2468,35.7
E02000991,6226,100,3804,61.1,3584,57.6,220,3.5,103,1.7,84,1.3,19,0.3,2319,37.2
E02000992,5199,100,3085,59.3,2978,57.3,107,2.1,84,1.6,67,1.3,17,0.3,2030,39
E02000993,6242,100,3684,59,3437,55.1,247,4,131,2.1,88,1.4,43,0.7,2427,38.9
E02000994,6647,100,3199,48.1,2845,42.8,354,5.3,221,3.3,164,2.5,57,0.9,3227,48.5
E02000995,6542,100,3548,54.2,3364,51.4,184,2.8,152,2.3,128,2,24,0.4,2842,43.4
E02000996,6368,100,3204,50.3,2870,45.1,334,5.2,154,2.4,88,1.4,66,1,3010,47.3
E02000997,5304,100,3114,58.7,3007,56.7,107,2,83,1.6,63,1.2,20,0.4,2107,39.7
E02000998,7745,100,4014,51.8,3616,46.7,398,5.1,237,3.1,135,1.7,102,1.3,3494,45.1
E02000999,6748,100,2960,43.9,2499,37,461,6.8,283,4.2,195,2.9,88,1.3,3505,51.9
E02001000,7440,100,4266,57.3,3949,53.1,317,4.3,160,2.2,120,1.6,40,0.5,3014,40.5
E02001001,6674,100,3761,56.4,3540,53,221,3.3,148,2.2,113,1.7,35,0.5,2765,41.4
E02001002,7670,100,4341,56.6,4067,53,274,3.6,150,2,107,1.4,43,0.6,3179,41.4
E02001003,6036,100,3148,52.2,3044,50.4,104,1.7,134,2.2,100,1.7,34,0.6,2754,45.6
E02001004,6770,100,3064,45.3,2707,40,357,5.3,218,3.2,151,2.2,67,1,3488,51.5
E02001005,7260,100,3662,50.4,3360,46.3,302,4.2,251,3.5,189,2.6,62,0.9,3347,46.1
E02001006,6208,100,3240,52.2,2976,47.9,264,4.3,172,2.8,119,1.9,53,0.9,2796,45
E02001007,8346,100,4664,55.9,4474,53.6,190,2.3,121,1.4,87,1,34,0.4,3561,42.7
E02001008,6343,100,3033,47.8,2733,43.1,300,4.7,207,3.3,163,2.6,44,0.7,3103,48.9
E02001009,5670,100,3155,55.6,2949,52,206,3.6,131,2.3,96,1.7,35,0.6,2384,42
E02001010,4918,100,2792,56.8,2571,52.3,221,4.5,110,2.2,90,1.8,20,0.4,2016,41
E02001011,8085,100,4963,61.4,4821,59.6,142,1.8,143,1.8,107,1.3,36,0.4,2979,36.8
E02001012,7077,100,3870,54.7,3679,52,191,2.7,171,2.4,122,1.7,49,0.7,3036,42.9
E02001013,4990,100,2804,56.2,2700,54.1,104,2.1,90,1.8,71,1.4,19,0.4,2096,42
E02001014,6888,100,4083,59.3,3874,56.2,209,3,94,1.4,74,1.1,20,0.3,2711,39.4
E02001015,6735,100,3689,54.8,3430,50.9,259,3.8,112,1.7,87,1.3,25,0.4,2934,43.6
E02001016,6503,100,3658,56.3,3387,52.1,271,4.2,170,2.6,126,1.9,44,0.7,2675,41.1
E02001017,8686,100,5484,63.1,5229,60.2,255,2.9,159,1.8,108,1.2,51,0.6,3043,35
E02001018,6244,100,4024,64.4,3909,62.6,115,1.8,126,2,94,1.5,32,0.5,2094,33.5
E02001019,7397,100,4560,61.6,4412,59.6,148,2,125,1.7,95,1.3,30,0.4,2712,36.7
E02001020,4980,100,2580,51.8,2516,50.5,64,1.3,88,1.8,69,1.4,19,0.4,2312,46.4
E02001021,6327,100,3818,60.3,3732,59,86,1.4,92,1.5,69,1.1,23,0.4,2417,38.2
E02001022,6609,100,3604,54.5,3439,52,165,2.5,110,1.7,81,1.2,29,0.4,2895,43.8
E02001023,4560,100,2516,55.2,2396,52.5,120,2.6,61,1.3,48,1.1,13,0.3,1983,43.5
E02001024,6604,100,4060,61.5,3944,59.7,116,1.8,154,2.3,126,1.9,28,0.4,2390,36.2
E02001025,6274,100,3387,54,3100,49.4,287,4.6,113,1.8,79,1.3,34,0.5,2774,44.2
E02001026,8594,100,4745,55.2,4313,50.2,432,5,198,2.3,133,1.5,65,0.8,3651,42.5
E02001027,5788,100,3638,62.9,3466,59.9,172,3,111,1.9,82,1.4,29,0.5,2039,35.2
E02001028,6179,100,3187,51.6,3114,50.4,73,1.2,119,1.9,86,1.4,33,0.5,2873,46.5
E02001029,6005,100,3287,54.7,3061,51,226,3.8,143,2.4,110,1.8,33,0.5,2575,42.9
E02001030,5123,100,3182,62.1,3094,60.4,88,1.7,104,2,79,1.5,25,0.5,1837,35.9
E02001031,5473,100,3088,56.4,2941,53.7,147,2.7,109,2,88,1.6,21,0.4,2276,41.6
E02001032,6235,100,3695,59.3,3553,57,142,2.3,109,1.7,88,1.4,21,0.3,2431,39
E02001033,4845,100,3037,62.7,2889,59.6,148,3.1,113,2.3,75,1.5,38,0.8,1695,35
E02001034,6812,100,3710,54.5,3425,50.3,285,4.2,110,1.6,80,1.2,30,0.4,2992,43.9
E02001035,5984,100,3460,57.8,3355,56.1,105,1.8,134,2.2,96,1.6,38,0.6,2390,39.9
E02001036,5874,100,3639,62,3454,58.8,185,3.1,128,2.2,91,1.5,37,0.6,2107,35.9
E02001037,5970,100,3516,58.9,3409,57.1,107,1.8,67,1.1,42,0.7,25,0.4,2387,40
E02001038,4702,100,2843,60.5,2723,57.9,120,2.6,78,1.7,62,1.3,16,0.3,1781,37.9
E02001039,6590,100,3924,59.5,3676,55.8,248,3.8,131,2,108,1.6,23,0.3,2535,38.5
E02001040,5278,100,3135,59.4,2993,56.7,142,2.7,78,1.5,53,1,25,0.5,2065,39.1
E02001041,6350,100,3958,62.3,3754,59.1,204,3.2,95,1.5,65,1,30,0.5,2297,36.2
E02001042,5311,100,3268,61.5,3131,59,137,2.6,86,1.6,66,1.2,20,0.4,1957,36.8
E02001043,4599,100,2790,60.7,2660,57.8,130,2.8,77,1.7,50,1.1,27,0.6,1732,37.7
E02001044,6396,100,3977,62.2,3805,59.5,172,2.7,107,1.7,93,1.5,14,0.2,2312,36.1
E02001045,6461,100,3462,53.6,3189,49.4,273,4.2,152,2.4,114,1.8,38,0.6,2847,44.1
E02001046,8421,100,4912,58.3,4518,53.7,394,4.7,204,2.4,156,1.9,48,0.6,3305,39.2
E02001047,8095,100,4512,55.7,4162,51.4,350,4.3,176,2.2,141,1.7,35,0.4,3407,42.1
E02001048,7017,100,3828,54.6,3542,50.5,286,4.1,176,2.5,139,2,37,0.5,3013,42.9
E02001049,8168,100,4709,57.7,4419,54.1,290,3.6,193,2.4,137,1.7,56,0.7,3266,40
E02001050,6012,100,3118,51.9,2793,46.5,325,5.4,192,3.2,137,2.3,55,0.9,2702,44.9
E02001051,6793,100,3825,56.3,3528,51.9,297,4.4,258,3.8,161,2.4,97,1.4,2710,39.9
E02001052,10538,100,5162,49,4675,44.4,487,4.6,411,3.9,264,2.5,147,1.4,4965,47.1
E02001053,8451,100,4239,50.2,3744,44.3,495,5.9,327,3.9,235,2.8,92,1.1,3885,46
E02001055,7214,100,3824,53,3498,48.5,326,4.5,176,2.4,142,2,34,0.5,3214,44.6
E02001056,6474,100,3268,50.5,2931,45.3,337,5.2,228,3.5,164,2.5,64,1,2978,46
E02001059,8876,100,4992,56.2,4550,51.3,442,5,304,3.4,217,2.4,87,1,3580,40.3
E02001061,8089,100,4342,53.7,3947,48.8,395,4.9,261,3.2,202,2.5,59,0.7,3486,43.1
E02001062,7882,100,3517,44.6,3138,39.8,379,4.8,566,7.2,349,4.4,217,2.8,3799,48.2
E02001063,9688,100,3455,35.7,3123,32.2,332,3.4,1298,13.4,739,7.6,559,5.8,4935,50.9
E02001064,7858,100,4008,51,3588,45.7,420,5.3,264,3.4,197,2.5,67,0.9,3586,45.6
E02001065,7067,100,4018,56.9,3648,51.6,370,5.2,182,2.6,129,1.8,53,0.7,2867,40.6
E02001066,9720,100,3461,35.6,3057,31.5,404,4.2,1158,11.9,702,7.2,456,4.7,5101,52.5
E02001067,8114,100,4438,54.7,3935,48.5,503,6.2,311,3.8,208,2.6,103,1.3,3365,41.5
E02001068,8377,100,4043,48.3,3580,42.7,463,5.5,455,5.4,285,3.4,170,2,3879,46.3
E02001069,9706,100,4150,42.8,3676,37.9,474,4.9,1036,10.7,637,6.6,399,4.1,4520,46.6
E02001070,10450,100,3291,31.5,2966,28.4,325,3.1,1143,10.9,684,6.5,459,4.4,6016,57.6
E02001072,7361,100,4783,65,4441,60.3,342,4.6,202,2.7,149,2,53,0.7,2376,32.3
E02001073,7903,100,5466,69.2,5221,66.1,245,3.1,142,1.8,111,1.4,31,0.4,2295,29
E02001074,9181,100,4984,54.3,4570,49.8,414,4.5,310,3.4,214,2.3,96,1,3887,42.3
E02001075,6933,100,4117,59.4,3775,54.4,342,4.9,191,2.8,143,2.1,48,0.7,2625,37.9
E02001076,10397,100,2369,22.8,2148,20.7,221,2.1,1963,18.9,1255,12.1,708,6.8,6065,58.3
E02001077,6132,100,4113,67.1,3939,64.2,174,2.8,121,2,93,1.5,28,0.5,1898,31
E02001078,8413,100,4651,55.3,4313,51.3,338,4,333,4,232,2.8,101,1.2,3429,40.8
E02001079,7696,100,3732,48.5,3428,44.5,304,4,504,6.5,353,4.6,151,2,3460,45
E02001080,8799,100,3056,34.7,2797,31.8,259,2.9,1290,14.7,857,9.7,433,4.9,4453,50.6
E02001081,5132,100,3546,69.1,3434,66.9,112,2.2,75,1.5,58,1.1,17,0.3,1511,29.4
E02001082,5890,100,3727,63.3,3556,60.4,171,2.9,353,6,253,4.3,100,1.7,1810,30.7
E02001083,7141,100,5428,76,5256,73.6,172,2.4,168,2.4,128,1.8,40,0.6,1545,21.6
E02001084,7237,100,4014,55.5,3802,52.5,212,2.9,450,6.2,318,4.4,132,1.8,2773,38.3
E02001085,6614,100,3590,54.3,3309,50,281,4.2,154,2.3,104,1.6,50,0.8,2870,43.4
E02001086,5631,100,3529,62.7,3339,59.3,190,3.4,112,2,87,1.5,25,0.4,1990,35.3
E02001087,7770,100,5240,67.4,5074,65.3,166,2.1,111,1.4,86,1.1,25,0.3,2419,31.1
E02001088,6946,100,4097,59,3814,54.9,283,4.1,114,1.6,78,1.1,36,0.5,2735,39.4
E02001089,6509,100,4189,64.4,4016,61.7,173,2.7,118,1.8,100,1.5,18,0.3,2202,33.8
E02001090,5805,100,3526,60.7,3361,57.9,165,2.8,59,1,40,0.7,19,0.3,2220,38.2
E02001091,6786,100,4033,59.4,3827,56.4,206,3,93,1.4,61,0.9,32,0.5,2660,39.2
E02001092,7063,100,4339,61.4,4035,57.1,304,4.3,168,2.4,132,1.9,36,0.5,2556,36.2
E02001093,7354,100,4215,57.3,3855,52.4,360,4.9,151,2.1,114,1.6,37,0.5,2988,40.6
E02001094,7158,100,3876,54.1,3506,49,370,5.2,202,2.8,152,2.1,50,0.7,3080,43
E02001095,6991,100,4101,58.7,3823,54.7,278,4,152,2.2,121,1.7,31,0.4,2738,39.2
E02001096,6395,100,3746,58.6,3505,54.8,241,3.8,121,1.9,70,1.1,51,0.8,2528,39.5
E02001097,6630,100,3893,58.7,3571,53.9,322,4.9,128,1.9,107,1.6,21,0.3,2609,39.4
E02006902,7325,100,5102,69.7,4741,64.7,361,4.9,411,5.6,310,4.2,101,1.4,1812,24.7
E02006912,9977,100,5824,58.4,5583,56,241,2.4,764,7.7,484,4.9,280,2.8,3389,34
E02006913,6275,100,3914,62.4,3651,58.2,263,4.2,225,3.6,162,2.6,63,1,2136,34
E02006914,7571,100,2162,28.6,2032,26.8,130,1.7,1260,16.6,597,7.9,663,8.8,4149,54.8
E02006915,6933,100,3438,49.6,3077,44.4,361,5.2,268,3.9,172,2.5,96,1.4,3227,46.5
E02006916,6295,100,4558,72.4,4257,67.6,301,4.8,328,5.2,231,3.7,97,1.5,1409,22.4
E02006917,6260,100,4484,71.6,4327,69.1,157,2.5,301,4.8,208,3.3,93,1.5,1475,23.6
E02006983,5832,100,3881,66.5,3670,62.9,211,3.6,174,3,141,2.4,33,0.6,1777,30.5
E02006984,5106,100,3884,76.1,3707,72.6,177,3.5,208,4.1,176,3.4,32,0.6,1014,19.9
E02006985,6477,100,2985,46.1,2687,41.5,298,4.6,279,4.3,184,2.8,95,1.5,3213,49.6
E02006986,4567,100,2512,55,2321,50.8,191,4.2,145,3.2,95,2.1,50,1.1,1910,41.8
E02001098,4979,100,2585,51.9,2487,49.9,98,2,62,1.2,48,1,14,0.3,2332,46.8
E02001099,4663,100,2771,59.4,2611,56,160,3.4,71,1.5,51,1.1,20,0.4,1821,39.1
E02001100,5001,100,2721,54.4,2585,51.7,136,2.7,96,1.9,70,1.4,26,0.5,2184,43.7
E02001101,4702,100,2709,57.6,2603,55.4,106,2.3,67,1.4,46,1,21,0.4,1926,41
E02001102,4862,100,3067,63.1,2948,60.6,119,2.4,82,1.7,56,1.2,26,0.5,1713,35.2
E02001103,4650,100,2619,56.3,2541,54.6,78,1.7,69,1.5,56,1.2,13,0.3,1962,42.2
E02001104,5680,100,3672,64.6,3508,61.8,164,2.9,106,1.9,78,1.4,28,0.5,1902,33.5
E02001105,4949,100,2797,56.5,2676,54.1,121,2.4,49,1,29,0.6,20,0.4,2103,42.5
E02001106,4989,100,2814,56.4,2661,53.3,153,3.1,70,1.4,52,1,18,0.4,2105,42.2
E02001107,5227,100,2842,54.4,2666,51,176,3.4,138,2.6,92,1.8,46,0.9,2247,43
E02001108,4342,100,2572,59.2,2369,54.6,203,4.7,89,2,57,1.3,32,0.7,1681,38.7
E02001109,6072,100,3358,55.3,3143,51.8,215,3.5,107,1.8,78,1.3,29,0.5,2607,42.9
E02001110,5437,100,3255,59.9,3168,58.3,87,1.6,55,1,41,0.8,14,0.3,2127,39.1
E02001111,6370,100,2996,47,2627,41.2,369,5.8,191,3,126,2,65,1,3183,50
E02001112,5005,100,3069,61.3,2988,59.7,81,1.6,82,1.6,62,1.2,20,0.4,1854,37
E02001113,6712,100,2997,44.7,2620,39,377,5.6,304,4.5,170,2.5,134,2,3411,50.8
E02001114,6905,100,3643,52.8,3374,48.9,269,3.9,168,2.4,114,1.7,54,0.8,3094,44.8
E02001115,4852,100,2891,59.6,2794,57.6,97,2,79,1.6,63,1.3,16,0.3,1882,38.8
E02001116,5455,100,2648,48.5,2428,44.5,220,4,144,2.6,107,2,37,0.7,2663,48.8
E02001117,5011,100,2822,56.3,2725,54.4,97,1.9,83,1.7,65,1.3,18,0.4,2106,42
E02001118,5060,100,2981,58.9,2894,57.2,87,1.7,68,1.3,50,1,18,0.4,2011,39.7
E02001119,8655,100,3783,43.7,3303,38.2,480,5.5,265,3.1,186,2.1,79,0.9,4607,53.2
E02001121,6030,100,2682,44.5,2372,39.3,310,5.1,217,3.6,133,2.2,84,1.4,3131,51.9
E02001123,5196,100,2726,52.5,2515,48.4,211,4.1,104,2,73,1.4,31,0.6,2366,45.5
E02001124,5267,100,2808,53.3,2600,49.4,208,3.9,108,2.1,71,1.3,37,0.7,2351,44.6
E02001125,6361,100,3797,59.7,3623,57,174,2.7,95,1.5,82,1.3,13,0.2,2469,38.8
E02001126,6640,100,3567,53.7,3280,49.4,287,4.3,139,2.1,106,1.6,33,0.5,2934,44.2
E02001127,5756,100,3201,55.6,2914,50.6,287,5,100,1.7,76,1.3,24,0.4,2455,42.7
E02001128,5980,100,3481,58.2,3266,54.6,215,3.6,104,1.7,78,1.3,26,0.4,2395,40.1
E02001129,5438,100,3272,60.2,3069,56.4,203,3.7,114,2.1,77,1.4,37,0.7,2052,37.7
E02001130,4913,100,2770,56.4,2648,53.9,122,2.5,59,1.2,47,1,12,0.2,2084,42.4
E02001131,4420,100,2626,59.4,2503,56.6,123,2.8,57,1.3,42,1,15,0.3,1737,39.3
E02007000,5311,100,2498,47,2207,41.6,291,5.5,162,3.1,106,2,56,1.1,2651,49.9
E02007001,6154,100,3016,49,2766,44.9,250,4.1,211,3.4,137,2.2,74,1.2,2927,47.6
E02001132,5460,100,3311,60.6,3205,58.7,106,1.9,76,1.4,59,1.1,17,0.3,2073,38
E02001133,5282,100,3246,61.5,3142,59.5,104,2,99,1.9,75,1.4,24,0.5,1937,36.7
E02001134,5258,100,3061,58.2,2963,56.4,98,1.9,69,1.3,54,1,15,0.3,2128,40.5
E02001135,6115,100,3133,51.2,2881,47.1,252,4.1,133,2.2,96,1.6,37,0.6,2849,46.6
E02001136,7730,100,4110,53.2,3920,50.7,190,2.5,126,1.6,94,1.2,32,0.4,3494,45.2
E02001137,5183,100,3186,61.5,3101,59.8,85,1.6,92,1.8,68,1.3,24,0.5,1905,36.8
E02001138,7212,100,3968,55,3842,53.3,126,1.7,125,1.7,95,1.3,30,0.4,3119,43.2
E02001139,7517,100,3711,49.4,3351,44.6,360,4.8,206,2.7,136,1.8,70,0.9,3600,47.9
E02001140,6096,100,3383,55.5,3150,51.7,233,3.8,107,1.8,72,1.2,35,0.6,2606,42.7
E02001141,8994,100,4236,47.1,3761,41.8,475,5.3,238,2.6,161,1.8,77,0.9,4520,50.3
E02001142,5044,100,2593,51.4,2484,49.2,109,2.2,92,1.8,69,1.4,23,0.5,2359,46.8
E02001143,8498,100,4372,51.4,4021,47.3,351,4.1,238,2.8,181,2.1,57,0.7,3888,45.8
E02001144,5202,100,2994,57.6,2871,55.2,123,2.4,78,1.5,54,1,24,0.5,2130,40.9
E02001145,5781,100,3462,59.9,3344,57.8,118,2,90,1.6,74,1.3,16,0.3,2229,38.6
E02001146,7561,100,3458,45.7,3106,41.1,352,4.7,220,2.9,147,1.9,73,1,3883,51.4
E02001147,7796,100,4534,58.2,4236,54.3,298,3.8,174,2.2,144,1.8,30,0.4,3088,39.6
E02001148,8331,100,4645,55.8,4398,52.8,247,3,137,1.6,96,1.2,41,0.5,3549,42.6
E02001149,8152,100,4654,57.1,4352,53.4,302,3.7,128,1.6,93,1.1,35,0.4,3370,41.3
E02001150,6889,100,3927,57,3700,53.7,227,3.3,147,2.1,116,1.7,31,0.4,2815,40.9
E02001151,8080,100,4978,61.6,4768,59,210,2.6,132,1.6,81,1,51,0.6,2970,36.8
E02001152,7679,100,4559,59.4,4281,55.7,278,3.6,151,2,112,1.5,39,0.5,2969,38.7
E02001153,9080,100,5158,56.8,4773,52.6,385,4.2,186,2,137,1.5,49,0.5,3736,41.1
E02001154,8073,100,4984,61.7,4718,58.4,266,3.3,129,1.6,91,1.1,38,0.5,2960,36.7
E02001155,5886,100,3347,56.9,3147,53.5,200,3.4,88,1.5,64,1.1,24,0.4,2451,41.6
E02001156,8036,100,4664,58,4470,55.6,194,2.4,130,1.6,101,1.3,29,0.4,3242,40.3
E02001157,6343,100,3341,52.7,3044,48,297,4.7,205,3.2,137,2.2,68,1.1,2797,44.1
E02001158,4748,100,2583,54.4,2378,50.1,205,4.3,89,1.9,65,1.4,24,0.5,2076,43.7
E02001159,5846,100,3933,67.3,3688,63.1,245,4.2,105,1.8,73,1.2,32,0.5,1808,30.9
E02001160,5373,100,2982,55.5,2807,52.2,175,3.3,106,2,68,1.3,38,0.7,2285,42.5
E02001161,4868,100,2825,58,2700,55.5,125,2.6,103,2.1,79,1.6,24,0.5,1940,39.9
E02001162,4846,100,2693,55.6,2556,52.7,137,2.8,82,1.7,54,1.1,28,0.6,2071,42.7
E02001163,8150,100,5032,61.7,4818,59.1,214,2.6,148,1.8,105,1.3,43,0.5,2970,36.4
E02001164,6033,100,3451,57.2,3159,52.4,292,4.8,128,2.1,110,1.8,18,0.3,2454,40.7
E02001165,4963,100,3130,63.1,2969,59.8,161,3.2,108,2.2,83,1.7,25,0.5,1725,34.8
E02001166,5398,100,3183,59,3033,56.2,150,2.8,87,1.6,62,1.1,25,0.5,2128,39.4
E02001167,5340,100,3148,59,2948,55.2,200,3.7,136,2.5,107,2,29,0.5,2056,38.5
E02001168,7853,100,4768,60.7,4556,58,212,2.7,132,1.7,104,1.3,28,0.4,2953,37.6
E02001169,8919,100,5460,61.2,5294,59.4,166,1.9,186,2.1,136,1.5,50,0.6,3273,36.7
E02001170,7975,100,4904,61.5,4771,59.8,133,1.7,132,1.7,96,1.2,36,0.5,2939,36.9
E02001171,5073,100,3161,62.3,3053,60.2,108,2.1,93,1.8,71,1.4,22,0.4,1819,35.9
E02001173,7669,100,3286,42.8,2968,38.7,318,4.1,878,11.4,596,7.8,282,3.7,3505,45.7
E02001174,4851,100,2982,61.5,2845,58.6,137,2.8,182,3.8,134,2.8,48,1,1687,34.8
E02001175,5938,100,3614,60.9,3412,57.5,202,3.4,124,2.1,99,1.7,25,0.4,2200,37
E02001176,9865,100,5997,60.8,5727,58.1,270,2.7,162,1.6,122,1.2,40,0.4,3706,37.6
E02001177,10878,100,6639,61,6188,56.9,451,4.1,365,3.4,271,2.5,94,0.9,3874,35.6
E02001179,5875,100,3444,58.6,3191,54.3,253,4.3,351,6,242,4.1,109,1.9,2080,35.4
E02001180,4642,100,2007,43.2,1781,38.4,226,4.9,317,6.8,174,3.7,143,3.1,2318,49.9
E02001181,4680,100,2741,58.6,2531,54.1,210,4.5,97,2.1,67,1.4,30,0.6,1842,39.4
E02001182,5808,100,3527,60.7,3260,56.1,267,4.6,165,2.8,96,1.7,69,1.2,2116,36.4
E02001183,5888,100,3723,63.2,3534,60,189,3.2,90,1.5,70,1.2,20,0.3,2075,35.2
E02001185,7762,100,4543,58.5,4305,55.5,238,3.1,136,1.8,92,1.2,44,0.6,3083,39.7
E02001186,8264,100,5219,63.2,4980,60.3,239,2.9,139,1.7,96,1.2,43,0.5,2906,35.2
E02006957,5058,100,2814,55.6,2489,49.2,325,6.4,122,2.4,88,1.7,34,0.7,2122,42
E02006958,6131,100,3517,57.4,3139,51.2,378,6.2,332,5.4,245,4,87,1.4,2282,37.2
E02006959,7587,100,5582,73.6,5240,69.1,342,4.5,473,6.2,326,4.3,147,1.9,1532,20.2
E02006960,8405,100,4591,54.6,4266,50.8,325,3.9,860,10.2,525,6.2,335,4,2954,35.1
E02006961,5562,100,3537,63.6,3279,59,258,4.6,293,5.3,204,3.7,89,1.6,1732,31.1
E02006962,4647,100,3366,72.4,3192,68.7,174,3.7,284,6.1,206,4.4,78,1.7,997,21.5
E02006963,5697,100,4509,79.1,4259,74.8,250,4.4,347,6.1,243,4.3,104,1.8,841,14.8
E02001187,5703,100,3537,62,3374,59.2,163,2.9,68,1.2,48,0.8,20,0.4,2098,36.8
E02001188,6823,100,4437,65,4177,61.2,260,3.8,157,2.3,118,1.7,39,0.6,2229,32.7
E02001189,6809,100,4327,63.5,4158,61.1,169,2.5,109,1.6,92,1.4,17,0.2,2373,34.9
E02001190,5969,100,3157,52.9,2865,48,292,4.9,99,1.7,80,1.3,19,0.3,2713,45.5
E02001191,4866,100,2728,56.1,2615,53.7,113,2.3,72,1.5,60,1.2,12,0.2,2066,42.5
E02001192,5445,100,3469,63.7,3364,61.8,105,1.9,78,1.4,64,1.2,14,0.3,1898,34.9
E02001193,5265,100,3365,63.9,3186,60.5,179,3.4,71,1.3,57,1.1,14,0.3,1829,34.7
E02001194,5110,100,3148,61.6,3051,59.7,97,1.9,62,1.2,42,0.8,20,0.4,1900,37.2
E02001195,6183,100,3803,61.5,3661,59.2,142,2.3,88,1.4,59,1,29,0.5,2292,37.1
E02001196,6510,100,3588,55.1,3427,52.6,161,2.5,87,1.3,60,0.9,27,0.4,2835,43.5
E02001197,5000,100,3173,63.5,3061,61.2,112,2.2,91,1.8,72,1.4,19,0.4,1736,34.7
E02001198,6095,100,3218,52.8,3041,49.9,177,2.9,81,1.3,53,0.9,28,0.5,2796,45.9
E02001199,6457,100,4045,62.6,3937,61,108,1.7,102,1.6,75,1.2,27,0.4,2310,35.8
E02001200,6345,100,3660,57.7,3316,52.3,344,5.4,93,1.5,66,1,27,0.4,2592,40.9
E02001201,4641,100,3126,67.4,3020,65.1,106,2.3,68,1.5,50,1.1,18,0.4,1447,31.2
E02001202,5301,100,3549,66.9,3364,63.5,185,3.5,94,1.8,74,1.4,20,0.4,1658,31.3
E02001203,4842,100,2705,55.9,2630,54.3,75,1.5,63,1.3,47,1,16,0.3,2074,42.8
E02001204,7156,100,4748,66.3,4544,63.5,204,2.9,92,1.3,72,1,20,0.3,2316,32.4
E02001205,6900,100,4371,63.3,4148,60.1,223,3.2,95,1.4,76,1.1,19,0.3,2434,35.3
E02001206,5919,100,3385,57.2,3263,55.1,122,2.1,79,1.3,60,1,19,0.3,2455,41.5
E02001207,5659,100,3417,60.4,3297,58.3,120,2.1,81,1.4,67,1.2,14,0.2,2161,38.2
E02001208,6204,100,3954,63.7,3794,61.2,160,2.6,100,1.6,77,1.2,23,0.4,2150,34.7
E02001209,6229,100,4151,66.6,3953,63.5,198,3.2,89,1.4,65,1,24,0.4,1989,31.9
E02001210,5818,100,3252,55.9,3065,52.7,187,3.2,127,2.2,92,1.6,35,0.6,2439,41.9
E02001211,5269,100,3209,60.9,3113,59.1,96,1.8,79,1.5,62,1.2,17,0.3,1981,37.6
E02001212,5198,100,3127,60.2,2964,57,163,3.1,80,1.5,60,1.2,20,0.4,1991,38.3
E02001213,8040,100,5280,65.7,5105,63.5,175,2.2,128,1.6,101,1.3,27,0.3,2632,32.7
E02001214,6502,100,3571,54.9,3431,52.8,140,2.2,96,1.5,84,1.3,12,0.2,2835,43.6
E02001215,4961,100,2725,54.9,2647,53.4,78,1.6,55,1.1,46,0.9,9,0.2,2181,44
E02001216,6352,100,3711,58.4,3592,56.5,119,1.9,108,1.7,81,1.3,27,0.4,2533,39.9
E02001217,5527,100,3398,61.5,3250,58.8,148,2.7,75,1.4,58,1,17,0.3,2054,37.2
E02001218,4869,100,2742,56.3,2626,53.9,116,2.4,91,1.9,81,1.7,10,0.2,2036,41.8
E02001219,4407,100,2559,58.1,2490,56.5,69,1.6,61,1.4,49,1.1,12,0.3,1787,40.5
E02001220,4527,100,2703,59.7,2586,57.1,117,2.6,56,1.2,40,0.9,16,0.4,1768,39.1
E02001221,4886,100,2752,56.3,2670,54.6,82,1.7,92,1.9,76,1.6,16,0.3,2042,41.8
E02001222,5254,100,2849,54.2,2731,52,118,2.2,109,2.1,91,1.7,18,0.3,2296,43.7
E02001223,5511,100,3116,56.5,3025,54.9,91,1.7,66,1.2,50,0.9,16,0.3,2329,42.3
E02001224,5037,100,2474,49.1,2413,47.9,61,1.2,68,1.4,47,0.9,21,0.4,2495,49.5
E02001225,5916,100,3572,60.4,3505,59.2,67,1.1,89,1.5,75,1.3,14,0.2,2255,38.1
E02001226,5685,100,3304,58.1,3163,55.6,141,2.5,103,1.8,77,1.4,26,0.5,2278,40.1
E02001227,4597,100,2539,55.2,2503,54.4,36,0.8,59,1.3,39,0.8,20,0.4,1999,43.5
E02001228,5137,100,2971,57.8,2890,56.3,81,1.6,64,1.2,50,1,14,0.3,2102,40.9
E02001229,8412,100,5357,63.7,5146,61.2,211,2.5,146,1.7,93,1.1,53,0.6,2909,34.6
E02001230,4889,100,2691,55,2595,53.1,96,2,99,2,73,1.5,26,0.5,2099,42.9
E02001231,5575,100,3444,61.8,3286,58.9,158,2.8,89,1.6,52,0.9,37,0.7,2042,36.6
E02001232,6751,100,3847,57,3591,53.2,256,3.8,150,2.2,117,1.7,33,0.5,2754,40.8
E02001233,6344,100,3351,52.8,3186,50.2,165,2.6,84,1.3,50,0.8,34,0.5,2909,45.9
E02001234,6109,100,3432,56.2,3196,52.3,236,3.9,127,2.1,86,1.4,41,0.7,2550,41.7
E02001235,5747,100,3504,61,3337,58.1,167,2.9,76,1.3,63,1.1,13,0.2,2167,37.7
E02001236,4680,100,2645,56.5,2463,52.6,182,3.9,68,1.5,48,1,20,0.4,1967,42
E02001237,5719,100,3550,62.1,3404,59.5,146,2.6,122,2.1,102,1.8,20,0.3,2047,35.8
E02001238,6547,100,3933,60.1,3760,57.4,173,2.6,115,1.8,71,1.1,44,0.7,2499,38.2
E02001239,7597,100,4646,61.2,4398,57.9,248,3.3,137,1.8,100,1.3,37,0.5,2814,37
E02001240,5188,100,3221,62.1,3056,58.9,165,3.2,125,2.4,80,1.5,45,0.9,1842,35.5
E02001241,8446,100,4344,51.4,3898,46.2,446,5.3,219,2.6,144,1.7,75,0.9,3883,46
E02001242,5706,100,3578,62.7,3444,60.4,134,2.3,107,1.9,66,1.2,41,0.7,2021,35.4
E02001243,6937,100,4060,58.5,3867,55.7,193,2.8,99,1.4,67,1,32,0.5,2778,40
E02001244,4486,100,2651,59.1,2567,57.2,84,1.9,69,1.5,61,1.4,8,0.2,1766,39.4
E02001245,6491,100,3971,61.2,3765,58,206,3.2,86,1.3,66,1,20,0.3,2434,37.5
E02001246,5959,100,3330,55.9,3147,52.8,183,3.1,92,1.5,72,1.2,20,0.3,2537,42.6
E02001247,5983,100,3617,60.5,3429,57.3,188,3.1,85,1.4,56,0.9,29,0.5,2281,38.1
E02001248,9328,100,5836,62.6,5537,59.4,299,3.2,178,1.9,139,1.5,39,0.4,3314,35.5
E02001249,5181,100,3075,59.4,2896,55.9,179,3.5,85,1.6,67,1.3,18,0.3,2021,39
E02001250,5427,100,3312,61,3194,58.9,118,2.2,89,1.6,72,1.3,17,0.3,2026,37.3
E02001251,5123,100,2970,58,2862,55.9,108,2.1,84,1.6,62,1.2,22,0.4,2069,40.4
E02001252,6302,100,3810,60.5,3679,58.4,131,2.1,94,1.5,79,1.3,15,0.2,2398,38.1
E02001253,4145,100,2472,59.6,2365,57.1,107,2.6,66,1.6,50,1.2,16,0.4,1607,38.8
E02001254,4610,100,2690,58.4,2559,55.5,131,2.8,67,1.5,48,1,19,0.4,1853,40.2
E02001255,5669,100,3373,59.5,3181,56.1,192,3.4,75,1.3,56,1,19,0.3,2221,39.2
E02001256,8153,100,4420,54.2,4114,50.5,306,3.8,199,2.4,153,1.9,46,0.6,3534,43.3
E02001257,7476,100,4098,54.8,3879,51.9,219,2.9,106,1.4,73,1,33,0.4,3272,43.8
E02001258,6147,100,3624,59,3513,57.1,111,1.8,80,1.3,65,1.1,15,0.2,2443,39.7
E02001259,9226,100,5292,57.4,4851,52.6,441,4.8,391,4.2,280,3,111,1.2,3543,38.4
E02001260,6152,100,3757,61.1,3618,58.8,139,2.3,113,1.8,80,1.3,33,0.5,2282,37.1
E02001261,6922,100,4627,66.8,4362,63,265,3.8,150,2.2,101,1.5,49,0.7,2145,31
E02001262,6862,100,3950,57.6,3697,53.9,253,3.7,170,2.5,129,1.9,41,0.6,2742,40
E02001263,6858,100,4072,59.4,3963,57.8,109,1.6,113,1.6,93,1.4,20,0.3,2673,39
E02001264,6735,100,4372,64.9,4190,62.2,182,2.7,123,1.8,97,1.4,26,0.4,2240,33.3
E02001265,6636,100,4056,61.1,3904,58.8,152,2.3,122,1.8,96,1.4,26,0.4,2458,37
E02001266,5576,100,3302,59.2,3120,56,182,3.3,94,1.7,71,1.3,23,0.4,2180,39.1
E02001267,6050,100,3694,61.1,3551,58.7,143,2.4,104,1.7,75,1.2,29,0.5,2252,37.2
E02001268,5820,100,3430,58.9,3335,57.3,95,1.6,97,1.7,73,1.3,24,0.4,2293,39.4
E02001269,6715,100,4118,61.3,3934,58.6,184,2.7,140,2.1,107,1.6,33,0.5,2457,36.6
E02001270,6726,100,4482,66.6,4327,64.3,155,2.3,76,1.1,54,0.8,22,0.3,2168,32.2
E02001271,5220,100,3208,61.5,3054,58.5,154,3,78,1.5,62,1.2,16,0.3,1934,37
E02001272,6365,100,4017,63.1,3870,60.8,147,2.3,79,1.2,62,1,17,0.3,2269,35.6
E02001273,7600,100,4998,65.8,4824,63.5,174,2.3,114,1.5,90,1.2,24,0.3,2488,32.7
E02001274,6539,100,3601,55.1,3486,53.3,115,1.8,105,1.6,81,1.2,24,0.4,2833,43.3
E02001275,6214,100,3459,55.7,3233,52,226,3.6,104,1.7,84,1.4,20,0.3,2651,42.7
E02001276,6243,100,3808,61,3643,58.4,165,2.6,89,1.4,72,1.2,17,0.3,2346,37.6
E02001277,7085,100,4509,63.6,4258,60.1,251,3.5,116,1.6,90,1.3,26,0.4,2460,34.7
E02001278,6755,100,4299,63.6,4173,61.8,126,1.9,116,1.7,94,1.4,22,0.3,2340,34.6
E02001279,6535,100,4175,63.9,4043,61.9,132,2,81,1.2,55,0.8,26,0.4,2279,34.9
E02001280,6609,100,3696,55.9,3516,53.2,180,2.7,116,1.8,83,1.3,33,0.5,2797,42.3
E02001281,6178,100,3662,59.3,3558,57.6,104,1.7,101,1.6,81,1.3,20,0.3,2415,39.1
E02001282,7822,100,5356,68.5,5177,66.2,179,2.3,115,1.5,89,1.1,26,0.3,2351,30.1
E02001283,7664,100,4732,61.7,4572,59.7,160,2.1,86,1.1,58,0.8,28,0.4,2846,37.1
E02001284,6268,100,4051,64.6,3939,62.8,112,1.8,117,1.9,94,1.5,23,0.4,2100,33.5
E02001285,6313,100,3558,56.4,3428,54.3,130,2.1,115,1.8,90,1.4,25,0.4,2640,41.8
E02001286,6470,100,3527,54.5,3426,53,101,1.6,89,1.4,68,1.1,21,0.3,2854,44.1
E02001287,5434,100,3557,65.5,3458,63.6,99,1.8,81,1.5,65,1.2,16,0.3,1796,33.1
E02001288,6956,100,4117,59.2,3975,57.1,142,2,127,1.8,91,1.3,36,0.5,2712,39
E02001289,8491,100,4782,56.3,4654,54.8,128,1.5,175,2.1,140,1.6,35,0.4,3534,41.6
E02001290,5145,100,2878,55.9,2790,54.2,88,1.7,119,2.3,96,1.9,23,0.4,2148,41.7
E02001291,6331,100,3664,57.9,3459,54.6,205,3.2,108,1.7,76,1.2,32,0.5,2559,40.4
E02001292,6759,100,3921,58,3797,56.2,124,1.8,118,1.7,97,1.4,21,0.3,2720,40.2
E02001293,5214,100,3057,58.6,2958,56.7,99,1.9,90,1.7,72,1.4,18,0.3,2067,39.6
E02001294,6668,100,4228,63.4,4041,60.6,187,2.8,148,2.2,110,1.6,38,0.6,2292,34.4
E02001295,5940,100,3123,52.6,2841,47.8,282,4.7,96,1.6,63,1.1,33,0.6,2721,45.8
E02001296,6645,100,3448,51.9,3113,46.8,335,5,119,1.8,84,1.3,35,0.5,3078,46.3
E02001297,5421,100,3101,57.2,2956,54.5,145,2.7,122,2.3,97,1.8,25,0.5,2198,40.5
E02001298,6340,100,3679,58,3418,53.9,261,4.1,128,2,91,1.4,37,0.6,2533,40
E02001299,7214,100,4327,60,4132,57.3,195,2.7,150,2.1,122,1.7,28,0.4,2737,37.9
E02001300,6476,100,3770,58.2,3606,55.7,164,2.5,115,1.8,102,1.6,13,0.2,2591,40
E02001301,7260,100,4362,60.1,4105,56.5,257,3.5,143,2,118,1.6,25,0.3,2755,37.9
E02001302,6405,100,3507,54.8,3324,51.9,183,2.9,119,1.9,78,1.2,41,0.6,2779,43.4
E02001303,6985,100,4006,57.4,3672,52.6,334,4.8,140,2,105,1.5,35,0.5,2839,40.6
E02001304,10565,100,6145,58.2,5991,56.7,154,1.5,219,2.1,157,1.5,62,0.6,4201,39.8
E02001305,7095,100,4103,57.8,3985,56.2,118,1.7,113,1.6,78,1.1,35,0.5,2879,40.6
E02001306,5998,100,3404,56.8,3287,54.8,117,2,120,2,99,1.7,21,0.4,2474,41.2
E02001307,9502,100,6064,63.8,5932,62.4,132,1.4,202,2.1,159,1.7,43,0.5,3236,34.1
E02001308,4997,100,2910,58.2,2772,55.5,138,2.8,63,1.3,42,0.8,21,0.4,2024,40.5
E02001309,6889,100,4327,62.8,4169,60.5,158,2.3,129,1.9,98,1.4,31,0.4,2433,35.3
E02001310,7260,100,4261,58.7,4019,55.4,242,3.3,139,1.9,115,1.6,24,0.3,2860,39.4
E02001311,6727,100,4008,59.6,3836,57,172,2.6,106,1.6,86,1.3,20,0.3,2613,38.8
E02001312,7006,100,4037,57.6,3825,54.6,212,3,118,1.7,85,1.2,33,0.5,2851,40.7
E02001313,6474,100,3505,54.1,3291,50.8,214,3.3,111,1.7,78,1.2,33,0.5,2858,44.1
E02001314,6334,100,4002,63.2,3847,60.7,155,2.4,115,1.8,84,1.3,31,0.5,2217,35
E02001315,7685,100,4964,64.6,4818,62.7,146,1.9,112,1.5,73,0.9,39,0.5,2609,33.9
E02001316,5932,100,3650,61.5,3347,56.4,303,5.1,87,1.5,75,1.3,12,0.2,2195,37
E02001317,7389,100,4414,59.7,4220,57.1,194,2.6,109,1.5,79,1.1,30,0.4,2866,38.8
E02001318,6496,100,3573,55,3421,52.7,152,2.3,134,2.1,92,1.4,42,0.6,2789,42.9
E02001319,6732,100,3995,59.3,3765,55.9,230,3.4,109,1.6,89,1.3,20,0.3,2628,39
E02001320,6091,100,3530,58,3362,55.2,168,2.8,85,1.4,56,0.9,29,0.5,2476,40.7
E02001321,6585,100,3960,60.1,3798,57.7,162,2.5,121,1.8,101,1.5,20,0.3,2504,38
E02001322,6088,100,3354,55.1,3236,53.2,118,1.9,104,1.7,84,1.4,20,0.3,2630,43.2
E02001323,6343,100,3661,57.7,3491,55,170,2.7,101,1.6,81,1.3,20,0.3,2581,40.7
E02001324,6667,100,4012,60.2,3841,57.6,171,2.6,107,1.6,83,1.2,24,0.4,2548,38.2
E02001325,7461,100,4647,62.3,4510,60.4,137,1.8,153,2.1,122,1.6,31,0.4,2661,35.7
E02001326,6694,100,3965,59.2,3836,57.3,129,1.9,125,1.9,92,1.4,33,0.5,2604,38.9
E02001327,6955,100,3859,55.5,3595,51.7,264,3.8,117,1.7,95,1.4,22,0.3,2979,42.8
E02001328,8551,100,5376,62.9,5186,60.6,190,2.2,154,1.8,125,1.5,29,0.3,3021,35.3
E02001329,5977,100,3258,54.5,3032,50.7,226,3.8,78,1.3,60,1,18,0.3,2641,44.2
E02001330,7240,100,4118,56.9,3848,53.1,270,3.7,135,1.9,92,1.3,43,0.6,2987,41.3
E02001331,8128,100,4443,54.7,4160,51.2,283,3.5,123,1.5,93,1.1,30,0.4,3562,43.8
E02001332,5943,100,3268,55,3039,51.1,229,3.9,111,1.9,77,1.3,34,0.6,2564,43.1
E02001333,7679,100,4502,58.6,4260,55.5,242,3.2,115,1.5,83,1.1,32,0.4,3062,39.9
E02001334,5068,100,2679,52.9,2452,48.4,227,4.5,116,2.3,75,1.5,41,0.8,2273,44.9
E02001335,6747,100,4282,63.5,4117,61,165,2.4,135,2,101,1.5,34,0.5,2330,34.5
E02001336,5427,100,2772,51.1,2531,46.6,241,4.4,85,1.6,71,1.3,14,0.3,2570,47.4
E02001337,4748,100,2807,59.1,2637,55.5,170,3.6,95,2,70,1.5,25,0.5,1846,38.9
E02001338,4900,100,2876,58.7,2743,56,133,2.7,82,1.7,54,1.1,28,0.6,1942,39.6
E02001339,5077,100,2810,55.3,2653,52.3,157,3.1,103,2,75,1.5,28,0.6,2164,42.6
E02001340,7962,100,5027,63.1,4867,61.1,160,2,141,1.8,108,1.4,33,0.4,2794,35.1
E02001341,6012,100,3299,54.9,3076,51.2,223,3.7,84,1.4,63,1,21,0.3,2629,43.7
E02001342,6660,100,3937,59.1,3844,57.7,93,1.4,102,1.5,79,1.2,23,0.3,2621,39.4
E02001343,6081,100,3699,60.8,3583,58.9,116,1.9,110,1.8,93,1.5,17,0.3,2272,37.4
E02001344,4617,100,2622,56.8,2503,54.2,119,2.6,77,1.7,60,1.3,17,0.4,1918,41.5
E02001345,4591,100,2717,59.2,2613,56.9,104,2.3,106,2.3,82,1.8,24,0.5,1768,38.5
E02001346,5932,100,3353,56.5,3116,52.5,237,4,108,1.8,84,1.4,24,0.4,2471,41.7
E02001347,6463,100,3750,58,3546,54.9,204,3.2,130,2,97,1.5,33,0.5,2583,40
E02001348,5488,100,3341,60.9,3135,57.1,206,3.8,140,2.6,106,1.9,34,0.6,2007,36.6
E02001349,6799,100,3958,58.2,3727,54.8,231,3.4,139,2,98,1.4,41,0.6,2702,39.7
E02001350,6345,100,3387,53.4,3172,50,215,3.4,115,1.8,83,1.3,32,0.5,2843,44.8
E02001351,7233,100,3669,50.7,3384,46.8,285,3.9,140,1.9,113,1.6,27,0.4,3424,47.3
E02001352,5190,100,2857,55,2657,51.2,200,3.9,113,2.2,76,1.5,37,0.7,2220,42.8
E02001353,5962,100,3658,61.4,3510,58.9,148,2.5,123,2.1,94,1.6,29,0.5,2181,36.6
E02001354,6310,100,3472,55,3228,51.2,244,3.9,96,1.5,66,1,30,0.5,2742,43.5
E02001355,5174,100,2769,53.5,2588,50,181,3.5,96,1.9,77,1.5,19,0.4,2309,44.6
E02001356,6543,100,3925,60,3669,56.1,256,3.9,142,2.2,119,1.8,23,0.4,2476,37.8
E02001357,5594,100,2876,51.4,2639,47.2,237,4.2,139,2.5,104,1.9,35,0.6,2579,46.1
E02001358,5573,100,2933,52.6,2605,46.7,328,5.9,111,2,89,1.6,22,0.4,2529,45.4
E02001359,4635,100,2542,54.8,2399,51.8,143,3.1,76,1.6,75,1.6,1,0,2017,43.5
E02001360,7079,100,3548,50.1,3215,45.4,333,4.7,189,2.7,151,2.1,38,0.5,3342,47.2
E02001361,5983,100,3221,53.8,3007,50.3,214,3.6,113,1.9,79,1.3,34,0.6,2649,44.3
E02001362,6246,100,3414,54.7,3209,51.4,205,3.3,116,1.9,86,1.4,30,0.5,2716,43.5
E02001363,6196,100,3353,54.1,3108,50.2,245,4,116,1.9,83,1.3,33,0.5,2727,44
E02001364,4935,100,2493,50.5,2255,45.7,238,4.8,105,2.1,67,1.4,38,0.8,2337,47.4
E02001365,7383,100,4064,55,3632,49.2,432,5.9,173,2.3,138,1.9,35,0.5,3146,42.6
E02001366,7190,100,4016,55.9,3664,51,352,4.9,117,1.6,87,1.2,30,0.4,3057,42.5
E02001367,8024,100,4721,58.8,4528,56.4,193,2.4,155,1.9,124,1.5,31,0.4,3148,39.2
E02001368,5861,100,2910,49.7,2656,45.3,254,4.3,149,2.5,113,1.9,36,0.6,2802,47.8
E02001369,6800,100,3049,44.8,2790,41,259,3.8,327,4.8,206,3,121,1.8,3424,50.4
E02001370,5656,100,2483,43.9,2186,38.6,297,5.3,163,2.9,121,2.1,42,0.7,3010,53.2
E02001371,5981,100,3333,55.7,3110,52,223,3.7,132,2.2,102,1.7,30,0.5,2516,42.1
E02001372,5055,100,2658,52.6,2501,49.5,157,3.1,75,1.5,52,1,23,0.5,2322,45.9
E02001373,7312,100,4135,56.6,3840,52.5,295,4,177,2.4,138,1.9,39,0.5,3000,41
E02001374,7112,100,3706,52.1,3312,46.6,394,5.5,308,4.3,224,3.1,84,1.2,3098,43.6
E02001375,5694,100,3085,54.2,2910,51.1,175,3.1,156,2.7,120,2.1,36,0.6,2453,43.1
E02001376,7687,100,2990,38.9,2692,35,298,3.9,730,9.5,516,6.7,214,2.8,3967,51.6
E02001377,11366,100,2856,25.1,2599,22.9,257,2.3,1468,12.9,917,8.1,551,4.8,7042,62
E02001378,6212,100,3431,55.2,3242,52.2,189,3,129,2.1,98,1.6,31,0.5,2652,42.7
E02001380,6198,100,3816,61.6,3669,59.2,147,2.4,121,2,98,1.6,23,0.4,2261,36.5
E02001381,7888,100,3912,49.6,3561,45.1,351,4.4,415,5.3,299,3.8,116,1.5,3561,45.1
E02001382,5631,100,3451,61.3,3337,59.3,114,2,106,1.9,77,1.4,29,0.5,2074,36.8
E02001383,8647,100,3329,38.5,2979,34.5,350,4,841,9.7,532,6.2,309,3.6,4477,51.8
E02001384,9749,100,2871,29.4,2650,27.2,221,2.3,1426,14.6,1031,10.6,395,4.1,5452,55.9
E02001385,6695,100,2859,42.7,2419,36.1,440,6.6,273,4.1,178,2.7,95,1.4,3563,53.2
E02001386,6706,100,3379,50.4,3127,46.6,252,3.8,101,1.5,69,1,32,0.5,3226,48.1
E02001387,6521,100,3756,57.6,3635,55.7,121,1.9,205,3.1,155,2.4,50,0.8,2560,39.3
E02001388,7169,100,3589,50.1,3412,47.6,177,2.5,509,7.1,335,4.7,174,2.4,3071,42.8
E02001389,5726,100,3408,59.5,3094,54,314,5.5,227,4,176,3.1,51,0.9,2091,36.5
E02001390,7695,100,3850,50,3475,45.2,375,4.9,203,2.6,148,1.9,55,0.7,3642,47.3
E02001391,4752,100,2435,51.2,2268,47.7,167,3.5,81,1.7,63,1.3,18,0.4,2236,47.1
E02001392,5281,100,2902,55,2840,53.8,62,1.2,76,1.4,49,0.9,27,0.5,2303,43.6
E02001393,6307,100,3170,50.3,3092,49,78,1.2,229,3.6,154,2.4,75,1.2,2908,46.1
E02001394,7658,100,4169,54.4,3945,51.5,224,2.9,282,3.7,215,2.8,67,0.9,3207,41.9
E02001395,4862,100,2978,61.3,2889,59.4,89,1.8,72,1.5,51,1,21,0.4,1812,37.3
E02001396,6580,100,3961,60.2,3740,56.8,221,3.4,187,2.8,144,2.2,43,0.7,2432,37
E02001397,6133,100,3222,52.5,3055,49.8,167,2.7,85,1.4,58,0.9,27,0.4,2826,46.1
E02001398,6491,100,3751,57.8,3548,54.7,203,3.1,217,3.3,167,2.6,50,0.8,2523,38.9
E02001399,5730,100,3344,58.4,3234,56.4,110,1.9,83,1.4,60,1,23,0.4,2303,40.2
E02001400,5644,100,3139,55.6,2988,52.9,151,2.7,84,1.5,66,1.2,18,0.3,2421,42.9
E02001401,6603,100,3833,58,3699,56,134,2,129,2,88,1.3,41,0.6,2641,40
E02001402,7398,100,4286,57.9,4139,55.9,147,2,141,1.9,114,1.5,27,0.4,2971,40.2
E02001403,5121,100,3025,59.1,2836,55.4,189,3.7,99,1.9,78,1.5,21,0.4,1997,39
E02001404,6215,100,3699,59.5,3478,56,221,3.6,90,1.4,65,1,25,0.4,2426,39
E02001405,7511,100,4102,54.6,3742,49.8,360,4.8,150,2,111,1.5,39,0.5,3259,43.4
E02006932,13851,100,3233,23.3,3009,21.7,224,1.6,2862,20.7,1553,11.2,1309,9.5,7756,56
E02006933,6746,100,4261,63.2,4045,60,216,3.2,450,6.7,366,5.4,84,1.2,2035,30.2
E02006934,6443,100,3738,58,3552,55.1,186,2.9,688,10.7,457,7.1,231,3.6,2017,31.3
E02001406,6677,100,3421,51.2,3325,49.8,96,1.4,104,1.6,71,1.1,33,0.5,3152,47.2
E02001407,5063,100,2531,50,2463,48.6,68,1.3,63,1.2,42,0.8,21,0.4,2469,48.8
E02001408,4644,100,2542,54.7,2449,52.7,93,2,86,1.9,67,1.4,19,0.4,2016,43.4
E02001409,8487,100,4690,55.3,4470,52.7,220,2.6,123,1.4,87,1,36,0.4,3674,43.3
E02001410,4697,100,2548,54.2,2446,52.1,102,2.2,71,1.5,55,1.2,16,0.3,2078,44.2
E02001411,4873,100,2697,55.3,2601,53.4,96,2,90,1.8,59,1.2,31,0.6,2086,42.8
E02001412,7402,100,4270,57.7,4096,55.3,174,2.4,143,1.9,103,1.4,40,0.5,2989,40.4
E02001413,7738,100,4193,54.2,3971,51.3,222,2.9,118,1.5,82,1.1,36,0.5,3427,44.3
E02001414,4612,100,2429,52.7,2361,51.2,68,1.5,73,1.6,62,1.3,11,0.2,2110,45.8
E02001415,5511,100,3366,61.1,3212,58.3,154,2.8,122,2.2,96,1.7,26,0.5,2023,36.7
E02001416,5013,100,2713,54.1,2514,50.1,199,4,75,1.5,55,1.1,20,0.4,2225,44.4
E02001417,6165,100,3370,54.7,3075,49.9,295,4.8,80,1.3,53,0.9,27,0.4,2715,44
E02001418,5333,100,3336,62.6,3178,59.6,158,3,70,1.3,50,0.9,20,0.4,1927,36.1
E02001419,6182,100,3457,55.9,3181,51.5,276,4.5,86,1.4,74,1.2,12,0.2,2639,42.7
E02001420,9500,100,5986,63,5735,60.4,251,2.6,141,1.5,113,1.2,28,0.3,3373,35.5
E02001421,8753,100,5256,60,4982,56.9,274,3.1,139,1.6,111,1.3,28,0.3,3358,38.4
E02001422,5187,100,2836,54.7,2644,51,192,3.7,77,1.5,53,1,24,0.5,2274,43.8
E02001423,5546,100,3127,56.4,3024,54.5,103,1.9,89,1.6,71,1.3,18,0.3,2330,42
E02001425,8943,100,5020,56.1,4779,53.4,241,2.7,175,2,135,1.5,40,0.4,3748,41.9
E02001426,4587,100,2463,53.7,2375,51.8,88,1.9,79,1.7,54,1.2,25,0.5,2045,44.6
E02001427,8711,100,5097,58.5,4801,55.1,296,3.4,167,1.9,130,1.5,37,0.4,3447,39.6
E02001428,4784,100,2461,51.4,2375,49.6,86,1.8,83,1.7,65,1.4,18,0.4,2240,46.8
E02006935,6050,100,3148,52,2958,48.9,190,3.1,120,2,94,1.6,26,0.4,2782,46
E02006936,6112,100,3858,63.1,3729,61,129,2.1,136,2.2,99,1.6,37,0.6,2118,34.7
E02001429,5687,100,2946,51.8,2838,49.9,108,1.9,94,1.7,71,1.2,23,0.4,2647,46.5
E02001430,5860,100,3091,52.7,2990,51,101,1.7,114,1.9,98,1.7,16,0.3,2655,45.3
E02001431,6662,100,2719,40.8,2606,39.1,113,1.7,70,1.1,53,0.8,17,0.3,3873,58.1
E02001432,8497,100,4428,52.1,4055,47.7,373,4.4,95,1.1,84,1,11,0.1,3974,46.8
E02001433,5882,100,3595,61.1,3449,58.6,146,2.5,121,2.1,90,1.5,31,0.5,2166,36.8
E02001434,5909,100,3591,60.8,3464,58.6,127,2.1,119,2,109,1.8,10,0.2,2199,37.2
E02001435,7242,100,4372,60.4,4120,56.9,252,3.5,156,2.2,116,1.6,40,0.6,2714,37.5
E02001436,7786,100,4580,58.8,4378,56.2,202,2.6,162,2.1,128,1.6,34,0.4,3044,39.1
E02001437,8210,100,3677,44.8,3489,42.5,188,2.3,120,1.5,97,1.2,23,0.3,4413,53.8
E02001438,5907,100,3512,59.5,3400,57.6,112,1.9,111,1.9,82,1.4,29,0.5,2284,38.7
E02001439,5384,100,2874,53.4,2732,50.7,142,2.6,100,1.9,75,1.4,25,0.5,2410,44.8
E02001440,5259,100,2335,44.4,2265,43.1,70,1.3,92,1.7,81,1.5,11,0.2,2832,53.9
E02001441,5426,100,2505,46.2,2456,45.3,49,0.9,78,1.4,57,1.1,21,0.4,2843,52.4
E02001442,5098,100,2529,49.6,2425,47.6,104,2,86,1.7,71,1.4,15,0.3,2483,48.7
E02001443,4759,100,2397,50.4,2319,48.7,78,1.6,87,1.8,72,1.5,15,0.3,2275,47.8
E02001444,4713,100,2586,54.9,2494,52.9,92,2,105,2.2,77,1.6,28,0.6,2022,42.9
E02001445,5800,100,3249,56,3147,54.3,102,1.8,95,1.6,77,1.3,18,0.3,2456,42.3
E02001446,6120,100,3396,55.5,3280,53.6,116,1.9,114,1.9,85,1.4,29,0.5,2610,42.6
E02001447,5176,100,2822,54.5,2711,52.4,111,2.1,83,1.6,69,1.3,14,0.3,2271,43.9
E02001448,5680,100,3274,57.6,3172,55.8,102,1.8,115,2,98,1.7,17,0.3,2291,40.3
E02001449,7818,100,4350,55.6,4211,53.9,139,1.8,116,1.5,87,1.1,29,0.4,3352,42.9
E02001450,7117,100,3869,54.4,3757,52.8,112,1.6,115,1.6,91,1.3,24,0.3,3133,44
E02001451,4824,100,2484,51.5,2338,48.5,146,3,97,2,64,1.3,33,0.7,2243,46.5
E02001452,5117,100,2619,51.2,2428,47.4,191,3.7,74,1.4,43,0.8,31,0.6,2424,47.4
E02001453,7294,100,4350,59.6,4214,57.8,136,1.9,147,2,107,1.5,40,0.5,2797,38.3
E02001454,6052,100,3466,57.3,3377,55.8,89,1.5,138,2.3,112,1.9,26,0.4,2448,40.4
E02001455,5936,100,3603,60.7,3506,59.1,97,1.6,121,2,98,1.7,23,0.4,2212,37.3
E02001456,6222,100,3692,59.3,3554,57.1,138,2.2,91,1.5,68,1.1,23,0.4,2439,39.2
E02001457,5488,100,3126,57,2883,52.5,243,4.4,93,1.7,71,1.3,22,0.4,2269,41.3
E02001458,6357,100,4060,63.9,3853,60.6,207,3.3,132,2.1,113,1.8,19,0.3,2165,34.1
E02001459,5549,100,3304,59.5,3111,56.1,193,3.5,101,1.8,79,1.4,22,0.4,2144,38.6
E02001460,6669,100,3491,52.3,3280,49.2,211,3.2,108,1.6,78,1.2,30,0.4,3070,46
E02001461,5685,100,3508,61.7,3356,59,152,2.7,104,1.8,75,1.3,29,0.5,2073,36.5
E02001462,6027,100,3322,55.1,3063,50.8,259,4.3,101,1.7,69,1.1,32,0.5,2604,43.2
E02001463,5929,100,3379,57,3165,53.4,214,3.6,142,2.4,107,1.8,35,0.6,2408,40.6
E02001464,5589,100,3080,55.1,2760,49.4,320,5.7,105,1.9,83,1.5,22,0.4,2404,43
E02001465,6406,100,3207,50.1,2920,45.6,287,4.5,84,1.3,67,1,17,0.3,3115,48.6
E02001466,7242,100,4150,57.3,3830,52.9,320,4.4,128,1.8,93,1.3,35,0.5,2964,40.9
E02001467,6570,100,3485,53,3323,50.6,162,2.5,64,1,45,0.7,19,0.3,3021,46
E02001468,6322,100,3553,56.2,3358,53.1,195,3.1,82,1.3,56,0.9,26,0.4,2687,42.5
E02001469,6436,100,3573,55.5,3440,53.4,133,2.1,115,1.8,90,1.4,25,0.4,2748,42.7
E02001470,6821,100,4006,58.7,3876,56.8,130,1.9,115,1.7,86,1.3,29,0.4,2700,39.6
E02001471,5817,100,3047,52.4,2814,48.4,233,4,95,1.6,75,1.3,20,0.3,2675,46
E02001472,5636,100,3284,58.3,3148,55.9,136,2.4,89,1.6,63,1.1,26,0.5,2263,40.2
E02001473,6251,100,3552,56.8,3394,54.3,158,2.5,109,1.7,75,1.2,34,0.5,2590,41.4
E02001474,5202,100,2667,51.3,2436,46.8,231,4.4,82,1.6,57,1.1,25,0.5,2453,47.2
E02001475,4902,100,2544,51.9,2394,48.8,150,3.1,65,1.3,48,1,17,0.3,2293,46.8
E02001476,6144,100,3408,55.5,3156,51.4,252,4.1,88,1.4,72,1.2,16,0.3,2648,43.1
E02001477,5704,100,2909,51,2661,46.7,248,4.3,114,2,90,1.6,24,0.4,2681,47
E02001478,6751,100,3561,52.7,3417,50.6,144,2.1,109,1.6,81,1.2,28,0.4,3081,45.6
E02001479,5025,100,2917,58,2829,56.3,88,1.8,84,1.7,57,1.1,27,0.5,2024,40.3
E02001480,6412,100,3430,53.5,3302,51.5,128,2,86,1.3,68,1.1,18,0.3,2896,45.2
E02001481,6761,100,3883,57.4,3732,55.2,151,2.2,107,1.6,80,1.2,27,0.4,2771,41
E02001482,6627,100,3127,47.2,2832,42.7,295,4.5,73,1.1,53,0.8,20,0.3,3427,51.7
E02001483,6087,100,3437,56.5,3359,55.2,78,1.3,78,1.3,60,1,18,0.3,2572,42.3
E02001484,6656,100,3657,54.9,3529,53,128,1.9,82,1.2,70,1.1,12,0.2,2917,43.8
E02001485,5296,100,2880,54.4,2721,51.4,159,3,82,1.5,62,1.2,20,0.4,2334,44.1
E02001486,7060,100,3670,52,3486,49.4,184,2.6,82,1.2,62,0.9,20,0.3,3308,46.9
E02001487,7178,100,3928,54.7,3665,51.1,263,3.7,97,1.4,75,1,22,0.3,3153,43.9
E02001488,6800,100,3958,58.2,3737,55,221,3.2,117,1.7,92,1.4,25,0.4,2725,40.1
E02001489,6904,100,3516,50.9,3414,49.4,102,1.5,97,1.4,72,1,25,0.4,3291,47.7
E02001490,6805,100,4089,60.1,3958,58.2,131,1.9,107,1.6,85,1.2,22,0.3,2609,38.3
E02001491,5318,100,2795,52.6,2655,49.9,140,2.6,99,1.9,71,1.3,28,0.5,2424,45.6
E02001492,6298,100,3323,52.8,3172,50.4,151,2.4,120,1.9,100,1.6,20,0.3,2855,45.3
E02001493,7019,100,3576,50.9,3271,46.6,305,4.3,109,1.6,79,1.1,30,0.4,3334,47.5
E02001494,5882,100,3074,52.3,2950,50.2,124,2.1,81,1.4,61,1,20,0.3,2727,46.4
E02001495,6432,100,3665,57,3453,53.7,212,3.3,117,1.8,102,1.6,15,0.2,2650,41.2
E02001496,5016,100,2804,55.9,2693,53.7,111,2.2,124,2.5,97,1.9,27,0.5,2088,41.6
E02001497,6429,100,3520,54.8,3326,51.7,194,3,113,1.8,83,1.3,30,0.5,2796,43.5
E02001498,5898,100,3472,58.9,3353,56.8,119,2,115,1.9,92,1.6,23,0.4,2311,39.2
E02001499,5562,100,2916,52.4,2830,50.9,86,1.5,84,1.5,57,1,27,0.5,2562,46.1
E02001500,6142,100,3329,54.2,3218,52.4,111,1.8,88,1.4,59,1,29,0.5,2725,44.4
E02001501,6356,100,3707,58.3,3584,56.4,123,1.9,110,1.7,81,1.3,29,0.5,2539,39.9
E02001502,7931,100,4820,60.8,4655,58.7,165,2.1,109,1.4,89,1.1,20,0.3,3002,37.9
E02001503,6384,100,3256,51,3147,49.3,109,1.7,91,1.4,63,1,28,0.4,3037,47.6
E02001504,5977,100,2915,48.8,2840,47.5,75,1.3,80,1.3,70,1.2,10,0.2,2982,49.9
E02001505,5346,100,2986,55.9,2881,53.9,105,2,106,2,81,1.5,25,0.5,2254,42.2
E02001506,7541,100,3698,49,3597,47.7,101,1.3,115,1.5,84,1.1,31,0.4,3728,49.4
E02001507,5849,100,3156,54,3067,52.4,89,1.5,91,1.6,63,1.1,28,0.5,2602,44.5
E02001508,6582,100,3855,58.6,3730,56.7,125,1.9,123,1.9,103,1.6,20,0.3,2604,39.6
E02002653,6152,100,3106,50.5,2754,44.8,352,5.7,109,1.8,65,1.1,44,0.7,2937,47.7
E02002654,5742,100,2941,51.2,2556,44.5,385,6.7,97,1.7,66,1.1,31,0.5,2704,47.1
E02002655,6586,100,3587,54.5,3280,49.8,307,4.7,119,1.8,80,1.2,39,0.6,2880,43.7
E02002656,4493,100,2397,53.3,2313,51.5,84,1.9,55,1.2,39,0.9,16,0.4,2041,45.4
E02002657,6192,100,3521,56.9,3364,54.3,157,2.5,126,2,93,1.5,33,0.5,2545,41.1
E02002658,5593,100,3182,56.9,3079,55.1,103,1.8,98,1.8,82,1.5,16,0.3,2313,41.4
E02002659,8538,100,4639,54.3,4102,48,537,6.3,163,1.9,123,1.4,40,0.5,3736,43.8
E02002660,5529,100,2958,53.5,2716,49.1,242,4.4,100,1.8,54,1,46,0.8,2471,44.7
E02002661,6572,100,3579,54.5,3359,51.1,220,3.3,122,1.9,79,1.2,43,0.7,2871,43.7
E02002662,6009,100,3271,54.4,3069,51.1,202,3.4,102,1.7,70,1.2,32,0.5,2636,43.9
E02002663,7280,100,2393,32.9,2257,31,136,1.9,901,12.4,575,7.9,326,4.5,3986,54.8
E02002664,5957,100,3692,62,3585,60.2,107,1.8,113,1.9,83,1.4,30,0.5,2152,36.1
E02002665,6496,100,3904,60.1,3760,57.9,144,2.2,141,2.2,110,1.7,31,0.5,2451,37.7
E02002666,6962,100,3987,57.3,3617,52,370,5.3,520,7.5,352,5.1,168,2.4,2455,35.3
E02002667,6026,100,3859,64,3632,60.3,227,3.8,85,1.4,51,0.8,34,0.6,2082,34.6
E02002668,6314,100,3069,48.6,2728,43.2,341,5.4,104,1.6,74,1.2,30,0.5,3141,49.7
E02002669,6826,100,4085,59.8,3816,55.9,269,3.9,350,5.1,271,4,79,1.2,2391,35
E02002670,6400,100,3633,56.8,3417,53.4,216,3.4,110,1.7,71,1.1,39,0.6,2657,41.5
E02002671,7344,100,4262,58,3978,54.2,284,3.9,140,1.9,102,1.4,38,0.5,2942,40.1
E02002672,5284,100,2777,52.6,2512,47.5,265,5,106,2,85,1.6,21,0.4,2401,45.4
E02002673,6138,100,3750,61.1,3517,57.3,233,3.8,97,1.6,62,1,35,0.6,2291,37.3
E02002674,5494,100,3524,64.1,3379,61.5,145,2.6,101,1.8,68,1.2,33,0.6,1869,34
E02002675,6789,100,3644,53.7,3256,48,388,5.7,106,1.6,73,1.1,33,0.5,3039,44.8
E02002676,6033,100,3789,62.8,3540,58.7,249,4.1,139,2.3,107,1.8,32,0.5,2105,34.9
E02002677,6881,100,4145,60.2,3822,55.5,323,4.7,115,1.7,91,1.3,24,0.3,2621,38.1
E02002678,6832,100,4620,67.6,4344,63.6,276,4,139,2,104,1.5,35,0.5,2073,30.3
E02002679,6365,100,3741,58.8,3608,56.7,133,2.1,130,2,107,1.7,23,0.4,2494,39.2
E02002680,8299,100,4878,58.8,4240,51.1,638,7.7,210,2.5,162,2,48,0.6,3211,38.7
E02002681,7125,100,4196,58.9,3759,52.8,437,6.1,127,1.8,75,1.1,52,0.7,2802,39.3
E02002682,8286,100,4906,59.2,4536,54.7,370,4.5,121,1.5,92,1.1,29,0.3,3259,39.3
E02006813,6715,100,3595,53.5,3338,49.7,257,3.8,120,1.8,92,1.4,28,0.4,3000,44.7
E02007079,6252,100,3994,63.9,3708,59.3,286,4.6,97,1.6,62,1,35,0.6,2161,34.6
E02007080,6386,100,5228,81.9,5123,80.2,105,1.6,158,2.5,118,1.8,40,0.6,1000,15.7
E02002684,8938,100,3673,41.1,3537,39.6,136,1.5,89,1,65,0.7,24,0.3,5176,57.9
E02002685,6826,100,2984,43.7,2871,42.1,113,1.7,76,1.1,66,1,10,0.1,3766,55.2
E02002686,6198,100,2625,42.4,2391,38.6,234,3.8,92,1.5,51,0.8,41,0.7,3481,56.2
E02002687,5036,100,2362,46.9,2185,43.4,177,3.5,73,1.4,62,1.2,11,0.2,2601,51.6
E02002688,4587,100,2195,47.9,1992,43.4,203,4.4,52,1.1,37,0.8,15,0.3,2340,51
E02002689,4943,100,2590,52.4,2508,50.7,82,1.7,66,1.3,52,1.1,14,0.3,2287,46.3
E02002691,6997,100,3809,54.4,3732,53.3,77,1.1,92,1.3,83,1.2,9,0.1,3096,44.2
E02002692,8155,100,4708,57.7,4556,55.9,152,1.9,131,1.6,101,1.2,30,0.4,3316,40.7
E02002693,6064,100,3242,53.5,3144,51.8,98,1.6,76,1.3,63,1,13,0.2,2746,45.3
E02002694,10757,100,6317,58.7,6141,57.1,176,1.6,181,1.7,138,1.3,43,0.4,4259,39.6
E02002695,7099,100,3065,43.2,2920,41.1,145,2,95,1.3,69,1,26,0.4,3939,55.5
E02002696,5374,100,3096,57.6,3024,56.3,72,1.3,153,2.8,131,2.4,22,0.4,2125,39.5
E02002697,6388,100,3498,54.8,3402,53.3,96,1.5,87,1.4,66,1,21,0.3,2803,43.9
E02002698,7016,100,4228,60.3,4098,58.4,130,1.9,105,1.5,92,1.3,13,0.2,2683,38.2
E02002699,8245,100,4580,55.5,4471,54.2,109,1.3,148,1.8,128,1.6,20,0.2,3517,42.7
E02002700,4834,100,2724,56.4,2589,53.6,135,2.8,101,2.1,74,1.5,27,0.6,2009,41.6
E02002701,7282,100,4317,59.3,4225,58,92,1.3,91,1.2,68,0.9,23,0.3,2874,39.5
E02002702,8558,100,4761,55.6,4563,53.3,198,2.3,127,1.5,107,1.3,20,0.2,3670,42.9
E02002703,7916,100,4437,56.1,4312,54.5,125,1.6,225,2.8,170,2.1,55,0.7,3254,41.1
E02002704,6174,100,3229,52.3,3110,50.4,119,1.9,74,1.2,54,0.9,20,0.3,2871,46.5
E02002705,5961,100,3095,51.9,2998,50.3,97,1.6,102,1.7,75,1.3,27,0.5,2764,46.4
E02002706,6118,100,3514,57.4,3410,55.7,104,1.7,95,1.6,72,1.2,23,0.4,2509,41
E02002707,5734,100,3278,57.2,3203,55.9,75,1.3,91,1.6,79,1.4,12,0.2,2365,41.2
E02002708,5038,100,2422,48.1,2304,45.7,118,2.3,74,1.5,50,1,24,0.5,2542,50.5
E02002709,7165,100,3785,52.8,3665,51.2,120,1.7,84,1.2,70,1,14,0.2,3296,46
E02002710,6043,100,3487,57.7,3380,55.9,107,1.8,126,2.1,106,1.8,20,0.3,2430,40.2
E02002711,6655,100,3539,53.2,3467,52.1,72,1.1,117,1.8,95,1.4,22,0.3,2999,45.1
E02002712,6326,100,3288,52,3175,50.2,113,1.8,94,1.5,75,1.2,19,0.3,2944,46.5
E02002714,6675,100,3629,54.4,3516,52.7,113,1.7,57,0.9,39,0.6,18,0.3,2989,44.8
E02002715,10853,100,7083,65.3,6923,63.8,160,1.5,214,2,181,1.7,33,0.3,3556,32.8
E02002716,7068,100,3959,56,3820,54,139,2,122,1.7,89,1.3,33,0.5,2987,42.3
E02002717,6549,100,4094,62.5,3945,60.2,149,2.3,135,2.1,113,1.7,22,0.3,2320,35.4
E02002718,6719,100,3683,54.8,3614,53.8,69,1,132,2,108,1.6,24,0.4,2904,43.2
E02002719,5654,100,3376,59.7,3275,57.9,101,1.8,90,1.6,75,1.3,15,0.3,2188,38.7
E02002720,6432,100,3858,60,3757,58.4,101,1.6,102,1.6,89,1.4,13,0.2,2472,38.4
E02002721,5626,100,3318,59,3196,56.8,122,2.2,67,1.2,55,1,12,0.2,2241,39.8
E02002722,7092,100,3249,45.8,2998,42.3,251,3.5,68,1,47,0.7,21,0.3,3775,53.2
E02002723,6967,100,4301,61.7,4094,58.8,207,3,68,1,50,0.7,18,0.3,2598,37.3
E02002724,7497,100,4701,62.7,4343,57.9,358,4.8,125,1.7,104,1.4,21,0.3,2671,35.6
E02002725,5766,100,3380,58.6,3263,56.6,117,2,63,1.1,53,0.9,10,0.2,2323,40.3
E02006814,6676,100,4029,60.4,3869,58,160,2.4,135,2,110,1.6,25,0.4,2512,37.6
E02006891,6878,100,3945,57.4,3825,55.6,120,1.7,112,1.6,97,1.4,15,0.2,2821,41
E02006892,5247,100,2845,54.2,2728,52,117,2.2,75,1.4,59,1.1,16,0.3,2327,44.3
E02002726,8440,100,4657,55.2,4422,52.4,235,2.8,149,1.8,115,1.4,34,0.4,3634,43.1
E02002727,3959,100,1726,43.6,1498,37.8,228,5.8,54,1.4,32,0.8,22,0.6,2179,55
E02002728,5978,100,3486,58.3,3182,53.2,304,5.1,83,1.4,59,1,24,0.4,2409,40.3
E02002729,4633,100,2513,54.2,2405,51.9,108,2.3,93,2,76,1.6,17,0.4,2027,43.8
E02002730,5342,100,2998,56.1,2766,51.8,232,4.3,137,2.6,97,1.8,40,0.7,2207,41.3
E02002731,4184,100,2410,57.6,2211,52.8,199,4.8,78,1.9,61,1.5,17,0.4,1696,40.5
E02002732,6566,100,3860,58.8,3779,57.6,81,1.2,134,2,101,1.5,33,0.5,2572,39.2
E02002733,4807,100,2796,58.2,2687,55.9,109,2.3,74,1.5,57,1.2,17,0.4,1937,40.3
E02002734,4458,100,2600,58.3,2501,56.1,99,2.2,76,1.7,46,1,30,0.7,1782,40
E02002736,4246,100,2531,59.6,2307,54.3,224,5.3,85,2,61,1.4,24,0.6,1630,38.4
E02002737,5836,100,3448,59.1,3296,56.5,152,2.6,121,2.1,83,1.4,38,0.7,2267,38.8
E02002738,5599,100,3252,58.1,3114,55.6,138,2.5,107,1.9,77,1.4,30,0.5,2240,40
E02002739,4719,100,2647,56.1,2526,53.5,121,2.6,71,1.5,45,1,26,0.6,2001,42.4
E02002740,4349,100,2339,53.8,2180,50.1,159,3.7,82,1.9,58,1.3,24,0.6,1928,44.3
E02002741,7250,100,4244,58.5,4046,55.8,198,2.7,172,2.4,139,1.9,33,0.5,2834,39.1
E02002743,4661,100,2011,43.1,1904,40.8,107,2.3,95,2,66,1.4,29,0.6,2555,54.8
E02002744,5145,100,2521,49,2293,44.6,228,4.4,108,2.1,69,1.3,39,0.8,2516,48.9
E02002745,6309,100,3145,49.8,3050,48.3,95,1.5,98,1.6,77,1.2,21,0.3,3066,48.6
E02002746,8000,100,4740,59.2,4609,57.6,131,1.6,153,1.9,111,1.4,42,0.5,3107,38.8
E02002747,7726,100,4417,57.2,4320,55.9,97,1.3,152,2,114,1.5,38,0.5,3157,40.9
E02002748,6881,100,3550,51.6,3451,50.2,99,1.4,118,1.7,92,1.3,26,0.4,3213,46.7
E02007081,8436,100,4783,56.7,4564,54.1,219,2.6,126,1.5,97,1.1,29,0.3,3527,41.8
E02002749,9890,100,5621,56.8,5398,54.6,223,2.3,125,1.3,96,1,29,0.3,4144,41.9
E02002750,5328,100,2963,55.6,2888,54.2,75,1.4,65,1.2,48,0.9,17,0.3,2300,43.2
E02002751,5257,100,2810,53.5,2678,50.9,132,2.5,76,1.4,48,0.9,28,0.5,2371,45.1
E02002752,5826,100,3266,56.1,3130,53.7,136,2.3,83,1.4,67,1.2,16,0.3,2477,42.5
E02002753,7297,100,3731,51.1,3579,49,152,2.1,98,1.3,73,1,25,0.3,3468,47.5
E02002754,6827,100,3841,56.3,3699,54.2,142,2.1,117,1.7,90,1.3,27,0.4,2869,42
E02002755,6042,100,3653,60.5,3417,56.6,236,3.9,86,1.4,67,1.1,19,0.3,2303,38.1
E02002756,7067,100,4323,61.2,3975,56.2,348,4.9,148,2.1,105,1.5,43,0.6,2596,36.7
E02002757,5052,100,3029,60,2864,56.7,165,3.3,103,2,89,1.8,14,0.3,1920,38
E02002758,5132,100,3110,60.6,2905,56.6,205,4,130,2.5,95,1.9,35,0.7,1892,36.9
E02002759,8123,100,4282,52.7,4119,50.7,163,2,116,1.4,89,1.1,27,0.3,3725,45.9
E02002760,4792,100,2513,52.4,2382,49.7,131,2.7,92,1.9,69,1.4,23,0.5,2187,45.6
E02002761,5459,100,3092,56.6,2964,54.3,128,2.3,82,1.5,59,1.1,23,0.4,2285,41.9
E02002762,5210,100,2864,55,2700,51.8,164,3.1,129,2.5,98,1.9,31,0.6,2217,42.6
E02002763,6805,100,4057,59.6,3814,56,243,3.6,184,2.7,144,2.1,40,0.6,2564,37.7
E02002764,4451,100,2447,55,2247,50.5,200,4.5,109,2.4,79,1.8,30,0.7,1895,42.6
E02002765,4926,100,2708,55,2547,51.7,161,3.3,90,1.8,70,1.4,20,0.4,2128,43.2
E02002766,7189,100,4019,55.9,3877,53.9,142,2,198,2.8,150,2.1,48,0.7,2972,41.3
E02002767,5692,100,3124,54.9,3053,53.6,71,1.2,113,2,89,1.6,24,0.4,2455,43.1
E02002768,6260,100,3447,55.1,3337,53.3,110,1.8,97,1.5,63,1,34,0.5,2716,43.4
E02002769,4847,100,2546,52.5,2464,50.8,82,1.7,77,1.6,58,1.2,19,0.4,2224,45.9
E02002770,5928,100,3281,55.3,3170,53.5,111,1.9,95,1.6,84,1.4,11,0.2,2552,43
E02002771,6056,100,3254,53.7,3140,51.8,114,1.9,51,0.8,39,0.6,12,0.2,2751,45.4
E02002772,5621,100,3505,62.4,3420,60.8,85,1.5,130,2.3,109,1.9,21,0.4,1986,35.3
E02002773,4835,100,2410,49.8,2362,48.9,48,1,70,1.4,46,1,24,0.5,2355,48.7
E02002774,5118,100,2727,53.3,2661,52,66,1.3,82,1.6,71,1.4,11,0.2,2309,45.1
E02002775,4818,100,2404,49.9,2308,47.9,96,2,67,1.4,46,1,21,0.4,2347,48.7
E02002776,5621,100,3396,60.4,3295,58.6,101,1.8,78,1.4,57,1,21,0.4,2147,38.2
E02002777,7374,100,5007,67.9,4884,66.2,123,1.7,133,1.8,115,1.6,18,0.2,2234,30.3
E02002778,6732,100,4000,59.4,3916,58.2,84,1.2,134,2,112,1.7,22,0.3,2598,38.6
E02002779,8155,100,4327,53.1,4240,52,87,1.1,259,3.2,198,2.4,61,0.7,3569,43.8
E02002780,6738,100,3940,58.5,3784,56.2,156,2.3,468,6.9,364,5.4,104,1.5,2330,34.6
E02002781,8775,100,4613,52.6,4405,50.2,208,2.4,980,11.2,712,8.1,268,3.1,3182,36.3
E02002782,5395,100,2726,50.5,2665,49.4,61,1.1,150,2.8,107,2,43,0.8,2519,46.7
E02002783,8392,100,5237,62.4,5083,60.6,154,1.8,159,1.9,141,1.7,18,0.2,2996,35.7
E02002784,10440,100,5135,49.2,4846,46.4,289,2.8,824,7.9,621,5.9,203,1.9,4481,42.9
E02002785,6858,100,3548,51.7,3443,50.2,105,1.5,368,5.4,289,4.2,79,1.2,2942,42.9
E02002786,8778,100,3751,42.7,3556,40.5,195,2.2,1067,12.2,835,9.5,232,2.6,3960,45.1
E02002787,7443,100,4765,64,4578,61.5,187,2.5,116,1.6,92,1.2,24,0.3,2562,34.4
E02002788,7025,100,4780,68,4642,66.1,138,2,207,2.9,167,2.4,40,0.6,2038,29
E02002789,7194,100,4515,62.8,4319,60,196,2.7,124,1.7,93,1.3,31,0.4,2555,35.5
E02002790,10480,100,4920,46.9,4711,45,209,2,815,7.8,640,6.1,175,1.7,4745,45.3
E02002791,5478,100,2972,54.3,2892,52.8,80,1.5,122,2.2,110,2,12,0.2,2384,43.5
E02002792,6518,100,4097,62.9,3955,60.7,142,2.2,172,2.6,148,2.3,24,0.4,2249,34.5
E02002793,7773,100,4589,59,4449,57.2,140,1.8,124,1.6,93,1.2,31,0.4,3060,39.4
E02002794,9649,100,2350,24.4,2280,23.6,70,0.7,1090,11.3,646,6.7,444,4.6,6209,64.3
E02002795,6873,100,3683,53.6,3615,52.6,68,1,98,1.4,78,1.1,20,0.3,3092,45
E02005742,6376,100,3603,56.5,3519,55.2,84,1.3,74,1.2,69,1.1,5,0.1,2699,42.3
E02005744,6891,100,3619,52.5,3548,51.5,71,1,71,1,58,0.8,13,0.2,3201,46.5
E02005746,5632,100,3294,58.5,3192,56.7,102,1.8,60,1.1,50,0.9,10,0.2,2278,40.4
E02005747,5740,100,3487,60.7,3331,58,156,2.7,76,1.3,65,1.1,11,0.2,2177,37.9
E02005748,6537,100,3885,59.4,3792,58,93,1.4,82,1.3,70,1.1,12,0.2,2570,39.3
E02005749,8342,100,4747,56.9,4631,55.5,116,1.4,126,1.5,103,1.2,23,0.3,3469,41.6
E02007041,8767,100,4683,53.4,4586,52.3,97,1.1,139,1.6,120,1.4,19,0.2,3945,45
E02005750,6641,100,3336,50.2,3206,48.3,130,2,98,1.5,81,1.2,17,0.3,3207,48.3
E02005751,7540,100,3753,49.8,3640,48.3,113,1.5,73,1,60,0.8,13,0.2,3714,49.3
E02005752,5958,100,3610,60.6,3532,59.3,78,1.3,94,1.6,81,1.4,13,0.2,2254,37.8
E02005754,6457,100,3486,54,3417,52.9,69,1.1,82,1.3,74,1.1,8,0.1,2889,44.7
E02005755,5734,100,3293,57.4,3204,55.9,89,1.6,70,1.2,59,1,11,0.2,2371,41.3
E02005756,5339,100,3398,63.6,3333,62.4,65,1.2,58,1.1,41,0.8,17,0.3,1883,35.3
E02005757,7410,100,4346,58.7,4239,57.2,107,1.4,75,1,58,0.8,17,0.2,2989,40.3
E02005758,7853,100,4684,59.6,4571,58.2,113,1.4,104,1.3,84,1.1,20,0.3,3065,39
E02005759,7898,100,4294,54.4,4191,53.1,103,1.3,93,1.2,86,1.1,7,0.1,3511,44.5
E02005760,5201,100,3236,62.2,3155,60.7,81,1.6,83,1.6,76,1.5,7,0.1,1882,36.2
E02007042,5808,100,3226,55.5,3136,54,90,1.5,89,1.5,71,1.2,18,0.3,2493,42.9
E02007043,5151,100,3061,59.4,2925,56.8,136,2.6,98,1.9,87,1.7,11,0.2,1992,38.7
E02005761,4616,100,2687,58.2,2631,57,56,1.2,61,1.3,54,1.2,7,0.2,1868,40.5
E02005762,5192,100,3079,59.3,2990,57.6,89,1.7,107,2.1,90,1.7,17,0.3,2006,38.6
E02005763,5328,100,3203,60.1,3123,58.6,80,1.5,69,1.3,59,1.1,10,0.2,2056,38.6
E02005764,8669,100,4986,57.5,4819,55.6,167,1.9,111,1.3,86,1,25,0.3,3572,41.2
E02005765,6035,100,3631,60.2,3554,58.9,77,1.3,80,1.3,69,1.1,11,0.2,2324,38.5
E02005766,5138,100,2938,57.2,2865,55.8,73,1.4,53,1,43,0.8,10,0.2,2147,41.8
E02005767,6066,100,3385,55.8,3314,54.6,71,1.2,103,1.7,87,1.4,16,0.3,2578,42.5
E02005768,6669,100,3618,54.3,3530,52.9,88,1.3,175,2.6,161,2.4,14,0.2,2876,43.1
E02005769,5830,100,3385,58.1,3261,55.9,124,2.1,75,1.3,59,1,16,0.3,2370,40.7
E02005770,7521,100,4722,62.8,4605,61.2,117,1.6,79,1.1,63,0.8,16,0.2,2720,36.2
E02005771,6134,100,4041,65.9,3899,63.6,142,2.3,90,1.5,81,1.3,9,0.1,2003,32.7
E02005772,4998,100,2703,54.1,2646,52.9,57,1.1,83,1.7,73,1.5,10,0.2,2212,44.3
E02005773,7526,100,4755,63.2,4542,60.4,213,2.8,123,1.6,102,1.4,21,0.3,2648,35.2
E02005774,7789,100,4976,63.9,4800,61.6,176,2.3,121,1.6,100,1.3,21,0.3,2692,34.6
E02005775,8189,100,5188,63.4,4979,60.8,209,2.6,114,1.4,102,1.2,12,0.1,2887,35.3
E02005776,7435,100,4440,59.7,4348,58.5,92,1.2,97,1.3,81,1.1,16,0.2,2898,39
E02005777,6709,100,3991,59.5,3893,58,98,1.5,88,1.3,71,1.1,17,0.3,2630,39.2
E02005778,5194,100,3070,59.1,3023,58.2,47,0.9,71,1.4,60,1.2,11,0.2,2053,39.5
E02005779,6320,100,3630,57.4,3520,55.7,110,1.7,115,1.8,96,1.5,19,0.3,2575,40.7
E02005780,8941,100,4956,55.4,4818,53.9,138,1.5,178,2,143,1.6,35,0.4,3807,42.6
E02005781,4997,100,2828,56.6,2778,55.6,50,1,67,1.3,58,1.2,9,0.2,2102,42.1
E02005782,6517,100,3649,56,3582,55,67,1,62,1,47,0.7,15,0.2,2806,43.1
E02005783,6898,100,3712,53.8,3570,51.8,142,2.1,100,1.4,87,1.3,13,0.2,3086,44.7
E02005784,4861,100,2952,60.7,2878,59.2,74,1.5,58,1.2,45,0.9,13,0.3,1851,38.1
E02005785,10991,100,7806,71,7541,68.6,265,2.4,163,1.5,120,1.1,43,0.4,3022,27.5
E02005786,5119,100,2878,56.2,2803,54.8,75,1.5,51,1,38,0.7,13,0.3,2190,42.8
E02005787,7353,100,4001,54.4,3888,52.9,113,1.5,96,1.3,79,1.1,17,0.2,3256,44.3
E02005788,5506,100,3003,54.5,2920,53,83,1.5,52,0.9,43,0.8,9,0.2,2451,44.5
E02005789,9235,100,4629,50.1,4491,48.6,138,1.5,112,1.2,102,1.1,10,0.1,4494,48.7
E02005790,6022,100,3159,52.5,3087,51.3,72,1.2,65,1.1,51,0.8,14,0.2,2798,46.5
E02005791,5719,100,3411,59.6,3326,58.2,85,1.5,58,1,48,0.8,10,0.2,2250,39.3
E02005794,7920,100,4705,59.4,4577,57.8,128,1.6,86,1.1,75,0.9,11,0.1,3129,39.5
E02007044,6213,100,4003,64.4,3862,62.2,141,2.3,86,1.4,80,1.3,6,0.1,2124,34.2
E02007045,5712,100,3322,58.2,3230,56.5,92,1.6,84,1.5,70,1.2,14,0.2,2306,40.4
E02005795,6047,100,3015,49.9,2877,47.6,138,2.3,80,1.3,64,1.1,16,0.3,2952,48.8
E02005796,5681,100,2903,51.1,2836,49.9,67,1.2,78,1.4,69,1.2,9,0.2,2700,47.5
E02005797,5203,100,2822,54.2,2693,51.8,129,2.5,70,1.3,56,1.1,14,0.3,2311,44.4
E02005798,7116,100,3568,50.1,3491,49.1,77,1.1,100,1.4,80,1.1,20,0.3,3448,48.5
E02005799,7911,100,3906,49.4,3785,47.8,121,1.5,138,1.7,112,1.4,26,0.3,3867,48.9
E02005800,6284,100,3415,54.3,3129,49.8,286,4.6,102,1.6,79,1.3,23,0.4,2767,44
E02005801,4391,100,2223,50.6,2064,47,159,3.6,79,1.8,60,1.4,19,0.4,2089,47.6
E02005802,6293,100,3853,61.2,3664,58.2,189,3,115,1.8,98,1.6,17,0.3,2325,36.9
E02005803,7776,100,4083,52.5,3908,50.3,175,2.3,140,1.8,117,1.5,23,0.3,3553,45.7
E02005804,6991,100,3490,49.9,3234,46.3,256,3.7,92,1.3,70,1,22,0.3,3409,48.8
E02005805,6600,100,3475,52.7,3367,51,108,1.6,70,1.1,58,0.9,12,0.2,3055,46.3
E02005806,6247,100,3518,56.3,3342,53.5,176,2.8,109,1.7,87,1.4,22,0.4,2620,41.9
E02005807,5485,100,2908,53,2827,51.5,81,1.5,91,1.7,83,1.5,8,0.1,2486,45.3
E02005808,10071,100,4432,44,4223,41.9,209,2.1,87,0.9,66,0.7,21,0.2,5552,55.1
E02005809,6247,100,3685,59,3567,57.1,118,1.9,99,1.6,86,1.4,13,0.2,2463,39.4
E02005810,7663,100,4814,62.8,4698,61.3,116,1.5,143,1.9,116,1.5,27,0.4,2706,35.3
E02005811,8100,100,4971,61.4,4859,60,112,1.4,141,1.7,111,1.4,30,0.4,2988,36.9
E02005812,9184,100,6086,66.3,5916,64.4,170,1.9,119,1.3,83,0.9,36,0.4,2979,32.4
E02005813,10535,100,7042,66.8,6676,63.4,366,3.5,170,1.6,136,1.3,34,0.3,3323,31.5
E02005814,5800,100,3281,56.6,3166,54.6,115,2,80,1.4,68,1.2,12,0.2,2439,42.1
E02005815,7224,100,4231,58.6,4136,57.3,95,1.3,108,1.5,84,1.2,24,0.3,2885,39.9
E02005816,7213,100,4475,62,4365,60.5,110,1.5,121,1.7,93,1.3,28,0.4,2617,36.3
E02005817,6172,100,3586,58.1,3463,56.1,123,2,85,1.4,58,0.9,27,0.4,2501,40.5
E02005818,7311,100,4496,61.5,4359,59.6,137,1.9,110,1.5,85,1.2,25,0.3,2705,37
E02001509,5663,100,3266,57.7,3146,55.6,120,2.1,77,1.4,50,0.9,27,0.5,2320,41
E02001510,4814,100,2653,55.1,2531,52.6,122,2.5,74,1.5,52,1.1,22,0.5,2087,43.4
E02001511,5056,100,2778,54.9,2675,52.9,103,2,57,1.1,43,0.9,14,0.3,2221,43.9
E02001512,7095,100,4160,58.6,4037,56.9,123,1.7,105,1.5,84,1.2,21,0.3,2830,39.9
E02001513,6377,100,3674,57.6,3562,55.9,112,1.8,79,1.2,49,0.8,30,0.5,2624,41.1
E02001514,6101,100,3466,56.8,3303,54.1,163,2.7,82,1.3,64,1,18,0.3,2553,41.8
E02001515,7497,100,3956,52.8,3687,49.2,269,3.6,128,1.7,82,1.1,46,0.6,3413,45.5
E02001516,4999,100,3010,60.2,2870,57.4,140,2.8,83,1.7,58,1.2,25,0.5,1906,38.1
E02001517,6696,100,3686,55,3558,53.1,128,1.9,115,1.7,86,1.3,29,0.4,2895,43.2
E02001518,8425,100,5083,60.3,4834,57.4,249,3,128,1.5,91,1.1,37,0.4,3214,38.1
E02001519,6268,100,3595,57.4,3419,54.5,176,2.8,103,1.6,64,1,39,0.6,2570,41
E02001520,9826,100,5595,56.9,5445,55.4,150,1.5,163,1.7,119,1.2,44,0.4,4068,41.4
E02001521,10031,100,6599,65.8,6233,62.1,366,3.6,177,1.8,135,1.3,42,0.4,3255,32.4
E02001522,7561,100,4001,52.9,3763,49.8,238,3.1,87,1.2,67,0.9,20,0.3,3473,45.9
E02001523,5736,100,3449,60.1,3317,57.8,132,2.3,112,2,84,1.5,28,0.5,2175,37.9
E02001524,5222,100,2870,55,2816,53.9,54,1,73,1.4,59,1.1,14,0.3,2279,43.6
E02001525,5567,100,3132,56.3,2906,52.2,226,4.1,72,1.3,55,1,17,0.3,2363,42.4
E02001526,4765,100,2517,52.8,2380,49.9,137,2.9,72,1.5,54,1.1,18,0.4,2176,45.7
E02001527,5009,100,2859,57.1,2759,55.1,100,2,72,1.4,56,1.1,16,0.3,2078,41.5
E02001528,8711,100,4680,53.7,4434,50.9,246,2.8,95,1.1,60,0.7,35,0.4,3936,45.2
E02001529,7756,100,4005,51.6,3784,48.8,221,2.8,125,1.6,99,1.3,26,0.3,3626,46.8
E02001530,5712,100,3262,57.1,3066,53.7,196,3.4,68,1.2,53,0.9,15,0.3,2382,41.7
E02001531,6360,100,3667,57.7,3465,54.5,202,3.2,82,1.3,65,1,17,0.3,2611,41.1
E02001532,8491,100,5140,60.5,4972,58.6,168,2,143,1.7,109,1.3,34,0.4,3208,37.8
E02001533,6201,100,3622,58.4,3466,55.9,156,2.5,105,1.7,82,1.3,23,0.4,2474,39.9
E02001534,7728,100,4703,60.9,4507,58.3,196,2.5,103,1.3,67,0.9,36,0.5,2922,37.8
E02001535,5432,100,3142,57.8,3066,56.4,76,1.4,73,1.3,60,1.1,13,0.2,2217,40.8
E02001536,7308,100,4205,57.5,4065,55.6,140,1.9,124,1.7,96,1.3,28,0.4,2979,40.8
E02001537,6912,100,4226,61.1,4056,58.7,170,2.5,127,1.8,109,1.6,18,0.3,2559,37
E02001538,6470,100,3505,54.2,3330,51.5,175,2.7,103,1.6,73,1.1,30,0.5,2862,44.2
E02001539,5174,100,2965,57.3,2806,54.2,159,3.1,95,1.8,85,1.6,10,0.2,2114,40.9
E02001540,9693,100,5641,58.2,5387,55.6,254,2.6,109,1.1,83,0.9,26,0.3,3943,40.7
E02001541,9480,100,5275,55.6,5052,53.3,223,2.4,113,1.2,79,0.8,34,0.4,4092,43.2
E02001542,5863,100,3122,53.2,2859,48.8,263,4.5,74,1.3,51,0.9,23,0.4,2667,45.5
E02001543,6321,100,3302,52.2,3108,49.2,194,3.1,84,1.3,57,0.9,27,0.4,2935,46.4
E02001544,6649,100,3732,56.1,3517,52.9,215,3.2,93,1.4,60,0.9,33,0.5,2824,42.5
E02001545,7112,100,3961,55.7,3858,54.2,103,1.4,110,1.5,84,1.2,26,0.4,3041,42.8
E02001546,7778,100,3574,46,3361,43.2,213,2.7,43,0.6,29,0.4,14,0.2,4161,53.5
E02001547,8573,100,5134,59.9,4843,56.5,291,3.4,156,1.8,108,1.3,48,0.6,3283,38.3
E02001548,6204,100,3520,56.7,3214,51.8,306,4.9,90,1.5,62,1,28,0.5,2594,41.8
E02001549,5088,100,2945,57.9,2857,56.2,88,1.7,54,1.1,40,0.8,14,0.3,2089,41.1
E02001550,6233,100,3832,61.5,3677,59,155,2.5,113,1.8,90,1.4,23,0.4,2288,36.7
E02001551,4851,100,2907,59.9,2738,56.4,169,3.5,70,1.4,57,1.2,13,0.3,1874,38.6
E02001552,6089,100,3784,62.1,3609,59.3,175,2.9,110,1.8,81,1.3,29,0.5,2195,36
E02001553,8127,100,4717,58,4470,55,247,3,139,1.7,111,1.4,28,0.3,3271,40.2
E02001554,5063,100,2998,59.2,2890,57.1,108,2.1,102,2,79,1.6,23,0.5,1963,38.8
E02001555,4509,100,2423,53.7,2358,52.3,65,1.4,38,0.8,22,0.5,16,0.4,2048,45.4
E02001556,7249,100,4107,56.7,3845,53,262,3.6,135,1.9,105,1.4,30,0.4,3007,41.5
E02001557,8476,100,5277,62.3,5011,59.1,266,3.1,165,1.9,132,1.6,33,0.4,3034,35.8
E02001558,5197,100,2691,51.8,2604,50.1,87,1.7,56,1.1,35,0.7,21,0.4,2450,47.1
E02001559,6310,100,3665,58.1,3549,56.2,116,1.8,83,1.3,63,1,20,0.3,2562,40.6
E02001560,9582,100,5425,56.6,4838,50.5,587,6.1,156,1.6,122,1.3,34,0.4,4001,41.8
E02001561,5026,100,2933,58.4,2633,52.4,300,6,93,1.9,72,1.4,21,0.4,2000,39.8
E02001562,4699,100,2536,54,2367,50.4,169,3.6,58,1.2,49,1,9,0.2,2105,44.8
E02001563,6676,100,3649,54.7,3523,52.8,126,1.9,83,1.2,65,1,18,0.3,2944,44.1
E02001564,6838,100,3891,56.9,3790,55.4,101,1.5,103,1.5,81,1.2,22,0.3,2844,41.6
E02001565,6585,100,3761,57.1,3643,55.3,118,1.8,110,1.7,96,1.5,14,0.2,2714,41.2
E02001566,6754,100,4486,66.4,4239,62.8,247,3.7,102,1.5,72,1.1,30,0.4,2166,32.1
E02001567,6917,100,3752,54.2,3516,50.8,236,3.4,126,1.8,91,1.3,35,0.5,3039,43.9
E02001568,5472,100,3141,57.4,2984,54.5,157,2.9,70,1.3,50,0.9,20,0.4,2261,41.3
E02001569,7011,100,3803,54.2,3500,49.9,303,4.3,102,1.5,69,1,33,0.5,3106,44.3
E02001570,5639,100,2815,49.9,2645,46.9,170,3,80,1.4,56,1,24,0.4,2744,48.7
E02001571,4989,100,2862,57.4,2746,55,116,2.3,68,1.4,55,1.1,13,0.3,2059,41.3
E02001572,6222,100,3637,58.5,3420,55,217,3.5,93,1.5,69,1.1,24,0.4,2492,40.1
E02001573,6095,100,3486,57.2,3291,54,195,3.2,62,1,45,0.7,17,0.3,2547,41.8
E02001574,5017,100,2929,58.4,2838,56.6,91,1.8,73,1.5,61,1.2,12,0.2,2015,40.2
E02001575,6156,100,3612,58.7,3402,55.3,210,3.4,89,1.4,67,1.1,22,0.4,2455,39.9
E02001576,5622,100,3605,64.1,3495,62.2,110,2,101,1.8,79,1.4,22,0.4,1916,34.1
E02001577,5604,100,2713,48.4,2624,46.8,89,1.6,68,1.2,49,0.9,19,0.3,2823,50.4
E02001578,9121,100,5746,63,5543,60.8,203,2.2,175,1.9,135,1.5,40,0.4,3200,35.1
E02001579,8052,100,4279,53.1,4088,50.8,191,2.4,119,1.5,90,1.1,29,0.4,3654,45.4
E02001580,7133,100,3932,55.1,3786,53.1,146,2,108,1.5,70,1,38,0.5,3093,43.4
E02001581,5055,100,2857,56.5,2739,54.2,118,2.3,65,1.3,47,0.9,18,0.4,2133,42.2
E02001582,6314,100,3608,57.1,3429,54.3,179,2.8,119,1.9,84,1.3,35,0.6,2587,41
E02001583,4423,100,2653,60,2513,56.8,140,3.2,62,1.4,39,0.9,23,0.5,1708,38.6
E02001584,5752,100,3359,58.4,3266,56.8,93,1.6,86,1.5,65,1.1,21,0.4,2307,40.1
E02001585,5043,100,2686,53.3,2477,49.1,209,4.1,74,1.5,49,1,25,0.5,2283,45.3
E02001586,6693,100,3438,51.4,3195,47.7,243,3.6,65,1,47,0.7,18,0.3,3190,47.7
E02001587,4783,100,2466,51.6,2303,48.1,163,3.4,60,1.3,54,1.1,6,0.1,2257,47.2
E02001588,5680,100,3179,56,2971,52.3,208,3.7,81,1.4,56,1,25,0.4,2420,42.6
E02001589,6554,100,3949,60.3,3834,58.5,115,1.8,123,1.9,91,1.4,32,0.5,2482,37.9
E02001590,5667,100,2888,51,2604,46,284,5,96,1.7,64,1.1,32,0.6,2683,47.3
E02001591,6288,100,3230,51.4,2919,46.4,311,4.9,92,1.5,76,1.2,16,0.3,2966,47.2
E02001592,7163,100,4085,57,3919,54.7,166,2.3,115,1.6,96,1.3,19,0.3,2963,41.4
E02001593,5575,100,2825,50.7,2569,46.1,256,4.6,123,2.2,98,1.8,25,0.4,2627,47.1
E02001594,5750,100,2786,48.5,2473,43,313,5.4,111,1.9,81,1.4,30,0.5,2853,49.6
E02001595,7013,100,4151,59.2,4005,57.1,146,2.1,126,1.8,88,1.3,38,0.5,2736,39
E02001596,6933,100,3634,52.4,3506,50.6,128,1.8,114,1.6,77,1.1,37,0.5,3185,45.9
E02001597,7481,100,4082,54.6,3779,50.5,303,4.1,116,1.6,77,1,39,0.5,3283,43.9
E02001598,7828,100,4228,54,4072,52,156,2,121,1.5,84,1.1,37,0.5,3479,44.4
E02001600,8932,100,4622,51.7,4371,48.9,251,2.8,173,1.9,137,1.5,36,0.4,4137,46.3
E02001602,7456,100,4331,58.1,4155,55.7,176,2.4,82,1.1,59,0.8,23,0.3,3043,40.8
E02001603,5966,100,3439,57.6,3265,54.7,174,2.9,65,1.1,43,0.7,22,0.4,2462,41.3
E02001604,9291,100,6365,68.5,6118,65.8,247,2.7,182,2,141,1.5,41,0.4,2744,29.5
E02001605,6204,100,3700,59.6,3555,57.3,145,2.3,82,1.3,56,0.9,26,0.4,2422,39
E02001606,6542,100,3550,54.3,3381,51.7,169,2.6,111,1.7,87,1.3,24,0.4,2881,44
E02001607,7211,100,4068,56.4,3877,53.8,191,2.6,111,1.5,79,1.1,32,0.4,3032,42
E02001608,5715,100,3542,62,3434,60.1,108,1.9,93,1.6,68,1.2,25,0.4,2080,36.4
E02001609,7144,100,3799,53.2,3687,51.6,112,1.6,109,1.5,87,1.2,22,0.3,3236,45.3
E02001610,7154,100,4236,59.2,4113,57.5,123,1.7,112,1.6,86,1.2,26,0.4,2806,39.2
E02007002,9647,100,5481,56.8,5308,55,173,1.8,187,1.9,131,1.4,56,0.6,3979,41.2
E02001611,6383,100,3551,55.6,3398,53.2,153,2.4,86,1.3,69,1.1,17,0.3,2746,43
E02001612,4755,100,2715,57.1,2607,54.8,108,2.3,75,1.6,62,1.3,13,0.3,1965,41.3
E02001613,8412,100,4700,55.9,4480,53.3,220,2.6,109,1.3,84,1,25,0.3,3603,42.8
E02001614,9374,100,5478,58.4,5287,56.4,191,2,158,1.7,126,1.3,32,0.3,3738,39.9
E02001615,6213,100,3382,54.4,3293,53,89,1.4,74,1.2,53,0.9,21,0.3,2757,44.4
E02001616,6000,100,3333,55.5,3163,52.7,170,2.8,96,1.6,77,1.3,19,0.3,2571,42.9
E02001617,4334,100,2559,59,2377,54.8,182,4.2,68,1.6,44,1,24,0.6,1707,39.4
E02001618,7954,100,4871,61.2,4748,59.7,123,1.5,149,1.9,112,1.4,37,0.5,2934,36.9
E02001619,7899,100,4361,55.2,4107,52,254,3.2,130,1.6,78,1,52,0.7,3408,43.1
E02001620,5243,100,2787,53.2,2582,49.2,205,3.9,111,2.1,85,1.6,26,0.5,2345,44.7
E02001621,4571,100,2470,54,2279,49.9,191,4.2,94,2.1,60,1.3,34,0.7,2007,43.9
E02001622,7103,100,3923,55.2,3639,51.2,284,4,104,1.5,71,1,33,0.5,3076,43.3
E02001623,6248,100,2777,44.4,2504,40.1,273,4.4,190,3,137,2.2,53,0.8,3281,52.5
E02001624,7611,100,4337,57,4098,53.8,239,3.1,127,1.7,91,1.2,36,0.5,3147,41.3
E02001625,6049,100,3099,51.2,2862,47.3,237,3.9,109,1.8,75,1.2,34,0.6,2841,47
E02001626,4818,100,2963,61.5,2869,59.5,94,2,79,1.6,61,1.3,18,0.4,1776,36.9
E02001627,5019,100,3353,66.8,3201,63.8,152,3,98,2,79,1.6,19,0.4,1568,31.2
E02001628,4765,100,2200,46.2,1991,41.8,209,4.4,116,2.4,84,1.8,32,0.7,2449,51.4
E02001629,5063,100,2580,51,2377,46.9,203,4,112,2.2,82,1.6,30,0.6,2371,46.8
E02001630,6787,100,3117,45.9,2819,41.5,298,4.4,196,2.9,126,1.9,70,1,3474,51.2
E02001631,6279,100,3971,63.2,3840,61.2,131,2.1,112,1.8,84,1.3,28,0.4,2196,35
E02001632,8870,100,4159,46.9,3749,42.3,410,4.6,278,3.1,200,2.3,78,0.9,4433,50
E02001633,6384,100,3582,56.1,3502,54.9,80,1.3,106,1.7,85,1.3,21,0.3,2696,42.2
E02001634,7722,100,5086,65.9,4894,63.4,192,2.5,207,2.7,164,2.1,43,0.6,2429,31.5
E02001635,5001,100,2772,55.4,2627,52.5,145,2.9,88,1.8,67,1.3,21,0.4,2141,42.8
E02001636,7755,100,3472,44.8,3157,40.7,315,4.1,332,4.3,212,2.7,120,1.5,3951,50.9
E02001637,6067,100,2714,44.7,2415,39.8,299,4.9,172,2.8,101,1.7,71,1.2,3181,52.4
E02001638,5197,100,2235,43,2132,41,103,2,625,12,477,9.2,148,2.8,2337,45
E02001639,5101,100,3037,59.5,2947,57.8,90,1.8,191,3.7,145,2.8,46,0.9,1873,36.7
E02001640,7572,100,2476,32.7,2337,30.9,139,1.8,997,13.2,748,9.9,249,3.3,4099,54.1
E02001642,8387,100,4917,58.6,4695,56,222,2.6,166,2,134,1.6,32,0.4,3304,39.4
E02001643,5044,100,2806,55.6,2724,54,82,1.6,85,1.7,59,1.2,26,0.5,2153,42.7
E02001646,7036,100,2355,33.5,2254,32,101,1.4,1065,15.1,742,10.5,323,4.6,3616,51.4
E02001647,5087,100,2863,56.3,2782,54.7,81,1.6,90,1.8,65,1.3,25,0.5,2134,42
E02001648,7303,100,2766,37.9,2694,36.9,72,1,529,7.2,284,3.9,245,3.4,4008,54.9
E02001649,8380,100,4598,54.9,4224,50.4,374,4.5,215,2.6,131,1.6,84,1,3567,42.6
E02001650,8512,100,3142,36.9,2938,34.5,204,2.4,1239,14.6,804,9.4,435,5.1,4131,48.5
E02001651,6515,100,3559,54.6,3460,53.1,99,1.5,109,1.7,78,1.2,31,0.5,2847,43.7
E02001652,11531,100,4068,35.3,3768,32.7,300,2.6,2064,17.9,1296,11.2,768,6.7,5399,46.8
E02001653,5953,100,3384,56.8,3133,52.6,251,4.2,200,3.4,144,2.4,56,0.9,2369,39.8
E02001654,5208,100,2923,56.1,2778,53.3,145,2.8,95,1.8,68,1.3,27,0.5,2190,42.1
E02001655,6080,100,3417,56.2,3194,52.5,223,3.7,89,1.5,66,1.1,23,0.4,2574,42.3
E02001656,6458,100,4013,62.1,3896,60.3,117,1.8,321,5,238,3.7,83,1.3,2124,32.9
E02001657,7155,100,4637,64.8,4514,63.1,123,1.7,183,2.6,137,1.9,46,0.6,2335,32.6
E02001658,3982,100,2035,51.1,1850,46.5,185,4.6,91,2.3,65,1.6,26,0.7,1856,46.6
E02001659,4866,100,2561,52.6,2374,48.8,187,3.8,98,2,71,1.5,27,0.6,2207,45.4
E02001660,8114,100,4944,60.9,4742,58.4,202,2.5,225,2.8,171,2.1,54,0.7,2945,36.3
E02001661,6151,100,3286,53.4,3028,49.2,258,4.2,143,2.3,98,1.6,45,0.7,2722,44.3
E02001662,6231,100,3524,56.6,3372,54.1,152,2.4,101,1.6,68,1.1,33,0.5,2606,41.8
E02001663,6048,100,4221,69.8,4097,67.7,124,2.1,124,2.1,91,1.5,33,0.5,1703,28.2
E02001664,5158,100,2871,55.7,2736,53,135,2.6,89,1.7,62,1.2,27,0.5,2198,42.6
E02001665,7888,100,4396,55.7,4284,54.3,112,1.4,108,1.4,86,1.1,22,0.3,3384,42.9
E02001666,4816,100,2983,61.9,2847,59.1,136,2.8,83,1.7,64,1.3,19,0.4,1750,36.3
E02001669,6464,100,4332,67,4141,64.1,191,3,103,1.6,90,1.4,13,0.2,2029,31.4
E02001670,4661,100,2463,52.8,2237,48,226,4.8,63,1.4,41,0.9,22,0.5,2135,45.8
E02001671,4923,100,2645,53.7,2526,51.3,119,2.4,74,1.5,57,1.2,17,0.3,2204,44.8
E02001672,5021,100,2904,57.8,2796,55.7,108,2.2,85,1.7,61,1.2,24,0.5,2032,40.5
E02001673,4319,100,2814,65.2,2738,63.4,76,1.8,74,1.7,58,1.3,16,0.4,1431,33.1
E02001674,7608,100,4242,55.8,4120,54.2,122,1.6,121,1.6,92,1.2,29,0.4,3245,42.7
E02001675,7119,100,3697,51.9,3440,48.3,257,3.6,81,1.1,58,0.8,23,0.3,3341,46.9
E02001676,4923,100,2830,57.5,2758,56,72,1.5,80,1.6,55,1.1,25,0.5,2013,40.9
E02001678,8546,100,4528,53,4419,51.7,109,1.3,123,1.4,95,1.1,28,0.3,3895,45.6
E02001679,4967,100,2742,55.2,2529,50.9,213,4.3,92,1.9,74,1.5,18,0.4,2133,42.9
E02001680,4901,100,2545,51.9,2274,46.4,271,5.5,80,1.6,55,1.1,25,0.5,2276,46.4
E02001681,6254,100,3447,55.1,3322,53.1,125,2,123,2,90,1.4,33,0.5,2684,42.9
E02006803,7731,100,4815,62.3,4691,60.7,124,1.6,166,2.1,130,1.7,36,0.5,2750,35.6
E02006843,10166,100,3870,38.1,3654,35.9,216,2.1,1327,13.1,846,8.3,481,4.7,4969,48.9
E02006844,7270,100,1916,26.4,1737,23.9,179,2.5,1236,17,833,11.5,403,5.5,4118,56.6
E02006868,9861,100,5034,51,4665,47.3,369,3.7,533,5.4,347,3.5,186,1.9,4294,43.5
E02006869,9089,100,5511,60.6,5245,57.7,266,2.9,117,1.3,90,1,27,0.3,3461,38.1
E02002183,4970,100,2406,48.4,2324,46.8,82,1.6,64,1.3,50,1,14,0.3,2500,50.3
E02002184,10925,100,5843,53.5,5666,51.9,177,1.6,184,1.7,133,1.2,51,0.5,4898,44.8
E02002185,4749,100,2828,59.5,2747,57.8,81,1.7,64,1.3,39,0.8,25,0.5,1857,39.1
E02002187,5019,100,2932,58.4,2851,56.8,81,1.6,88,1.8,69,1.4,19,0.4,1999,39.8
E02002188,6303,100,3797,60.2,3640,57.8,157,2.5,127,2,110,1.7,17,0.3,2379,37.7
E02002189,5469,100,2690,49.2,2507,45.8,183,3.3,170,3.1,125,2.3,45,0.8,2609,47.7
E02002190,8981,100,4755,52.9,4356,48.5,399,4.4,287,3.2,187,2.1,100,1.1,3939,43.9
E02002191,7133,100,3820,53.6,3548,49.7,272,3.8,174,2.4,123,1.7,51,0.7,3139,44
E02002192,7638,100,4312,56.5,4221,55.3,91,1.2,112,1.5,85,1.1,27,0.4,3214,42.1
E02002193,5127,100,2767,54,2570,50.1,197,3.8,79,1.5,64,1.2,15,0.3,2281,44.5
E02002194,5912,100,3335,56.4,3193,54,142,2.4,93,1.6,75,1.3,18,0.3,2484,42
E02002195,5387,100,2944,54.7,2882,53.5,62,1.2,74,1.4,47,0.9,27,0.5,2369,44
E02002196,5176,100,3162,61.1,3052,59,110,2.1,89,1.7,61,1.2,28,0.5,1925,37.2
E02002197,7201,100,4458,61.9,4271,59.3,187,2.6,105,1.5,70,1,35,0.5,2638,36.6
E02002198,6911,100,4092,59.2,3918,56.7,174,2.5,76,1.1,59,0.9,17,0.2,2743,39.7
E02002199,6010,100,3915,65.1,3801,63.2,114,1.9,81,1.3,72,1.2,9,0.1,2014,33.5
E02002200,7458,100,4270,57.3,4134,55.4,136,1.8,124,1.7,99,1.3,25,0.3,3064,41.1
E02002201,9913,100,6252,63.1,5969,60.2,283,2.9,138,1.4,107,1.1,31,0.3,3523,35.5
E02002202,6194,100,3853,62.2,3593,58,260,4.2,92,1.5,61,1,31,0.5,2249,36.3
E02002203,6132,100,3595,58.6,3361,54.8,234,3.8,75,1.2,45,0.7,30,0.5,2462,40.2
E02002204,9493,100,5418,57.1,5256,55.4,162,1.7,132,1.4,110,1.2,22,0.2,3943,41.5
E02002205,8312,100,5007,60.2,4840,58.2,167,2,110,1.3,89,1.1,21,0.3,3195,38.4
E02002206,6973,100,4043,58,3822,54.8,221,3.2,109,1.6,82,1.2,27,0.4,2821,40.5
E02002207,5683,100,3012,53,2778,48.9,234,4.1,143,2.5,101,1.8,42,0.7,2528,44.5
E02002208,6326,100,3591,56.8,3364,53.2,227,3.6,102,1.6,79,1.2,23,0.4,2633,41.6
E02002209,4965,100,2819,56.8,2603,52.4,216,4.4,132,2.7,108,2.2,24,0.5,2014,40.6
E02002210,5958,100,3395,57,3167,53.2,228,3.8,122,2,92,1.5,30,0.5,2441,41
E02002211,5910,100,2811,47.6,2573,43.5,238,4,157,2.7,110,1.9,47,0.8,2942,49.8
E02002212,6380,100,3155,49.5,2838,44.5,317,5,177,2.8,130,2,47,0.7,3048,47.8
E02002213,6229,100,3772,60.6,3655,58.7,117,1.9,92,1.5,66,1.1,26,0.4,2365,38
E02002214,4957,100,2993,60.4,2815,56.8,178,3.6,98,2,78,1.6,20,0.4,1866,37.6
E02002215,8043,100,3800,47.2,3419,42.5,381,4.7,292,3.6,179,2.2,113,1.4,3951,49.1
E02002216,7624,100,3480,45.6,3064,40.2,416,5.5,229,3,178,2.3,51,0.7,3915,51.4
E02002217,7436,100,3508,47.2,3157,42.5,351,4.7,248,3.3,155,2.1,93,1.3,3680,49.5
E02002218,7605,100,4120,54.2,3831,50.4,289,3.8,158,2.1,111,1.5,47,0.6,3327,43.7
E02002219,5858,100,2798,47.8,2447,41.8,351,6,150,2.6,86,1.5,64,1.1,2910,49.7
E02002220,6818,100,3327,48.8,3029,44.4,298,4.4,206,3,150,2.2,56,0.8,3285,48.2
E02002222,6607,100,3390,51.3,3105,47,285,4.3,125,1.9,90,1.4,35,0.5,3092,46.8
E02002223,5585,100,2570,46,2256,40.4,314,5.6,182,3.3,116,2.1,66,1.2,2833,50.7
E02002224,7700,100,3259,42.3,2899,37.6,360,4.7,241,3.1,152,2,89,1.2,4200,54.5
E02002225,6855,100,3979,58,3826,55.8,153,2.2,121,1.8,85,1.2,36,0.5,2755,40.2
E02002226,10694,100,4220,39.5,3639,34,581,5.4,976,9.1,582,5.4,394,3.7,5498,51.4
E02002227,4595,100,2218,48.3,1912,41.6,306,6.7,98,2.1,57,1.2,41,0.9,2279,49.6
E02002228,5606,100,3016,53.8,2696,48.1,320,5.7,83,1.5,58,1,25,0.4,2507,44.7
E02002229,6475,100,3630,56.1,3439,53.1,191,2.9,95,1.5,72,1.1,23,0.4,2750,42.5
E02002230,6053,100,2836,46.9,2433,40.2,403,6.7,181,3,124,2,57,0.9,3036,50.2
E02002231,9994,100,5425,54.3,5045,50.5,380,3.8,285,2.9,217,2.2,68,0.7,4284,42.9
E02002232,5264,100,2609,49.6,2308,43.8,301,5.7,132,2.5,89,1.7,43,0.8,2523,47.9
E02002233,6829,100,3089,45.2,2693,39.4,396,5.8,192,2.8,114,1.7,78,1.1,3548,52
E02002234,5465,100,2748,50.3,2416,44.2,332,6.1,112,2,59,1.1,53,1,2605,47.7
E02002235,5097,100,2581,50.6,2287,44.9,294,5.8,133,2.6,89,1.7,44,0.9,2383,46.8
E02002236,5009,100,2846,56.8,2688,53.7,158,3.2,104,2.1,73,1.5,31,0.6,2059,41.1
E02002237,6641,100,3881,58.4,3645,54.9,236,3.6,151,2.3,108,1.6,43,0.6,2609,39.3
E02002238,4862,100,2614,53.8,2383,49,231,4.8,102,2.1,67,1.4,35,0.7,2146,44.1
E02002239,8280,100,5084,61.4,4789,57.8,295,3.6,135,1.6,100,1.2,35,0.4,3061,37
E02002240,9359,100,5988,64,5770,61.7,218,2.3,148,1.6,122,1.3,26,0.3,3223,34.4
E02002241,9353,100,5473,58.5,5204,55.6,269,2.9,149,1.6,118,1.3,31,0.3,3731,39.9
E02002242,6541,100,3805,58.2,3611,55.2,194,3,86,1.3,48,0.7,38,0.6,2650,40.5
E02002243,7629,100,4322,56.7,4067,53.3,255,3.3,123,1.6,98,1.3,25,0.3,3184,41.7
E02006945,7287,100,4432,60.8,4312,59.2,120,1.6,106,1.5,79,1.1,27,0.4,2749,37.7
E02006946,4343,100,2586,59.5,2528,58.2,58,1.3,52,1.2,33,0.8,19,0.4,1705,39.3
E02006947,7279,100,3487,47.9,2988,41,499,6.9,199,2.7,136,1.9,63,0.9,3593,49.4
E02006948,4979,100,2642,53.1,2328,46.8,314,6.3,203,4.1,130,2.6,73,1.5,2134,42.9
E02002244,4999,100,2939,58.8,2826,56.5,113,2.3,65,1.3,44,0.9,21,0.4,1995,39.9
E02002245,4061,100,2174,53.5,1993,49.1,181,4.5,82,2,55,1.4,27,0.7,1805,44.4
E02002246,8032,100,4761,59.3,4656,58,105,1.3,133,1.7,102,1.3,31,0.4,3138,39.1
E02002247,7510,100,4616,61.5,4428,59,188,2.5,95,1.3,73,1,22,0.3,2799,37.3
E02002248,6090,100,3508,57.6,3302,54.2,206,3.4,72,1.2,55,0.9,17,0.3,2510,41.2
E02002249,4235,100,2416,57,2224,52.5,192,4.5,71,1.7,47,1.1,24,0.6,1748,41.3
E02002250,6906,100,3860,55.9,3711,53.7,149,2.2,103,1.5,81,1.2,22,0.3,2943,42.6
E02002251,6718,100,3813,56.8,3520,52.4,293,4.4,100,1.5,81,1.2,19,0.3,2805,41.8
E02002252,5381,100,3075,57.1,2964,55.1,111,2.1,83,1.5,59,1.1,24,0.4,2223,41.3
E02002253,6167,100,3260,52.9,2982,48.4,278,4.5,142,2.3,92,1.5,50,0.8,2765,44.8
E02002254,5129,100,3083,60.1,2981,58.1,102,2,78,1.5,57,1.1,21,0.4,1968,38.4
E02002255,5677,100,2445,43.1,2134,37.6,311,5.5,147,2.6,85,1.5,62,1.1,3085,54.3
E02002256,7614,100,4368,57.4,4145,54.4,223,2.9,124,1.6,103,1.4,21,0.3,3122,41
E02002257,4714,100,2354,49.9,2095,44.4,259,5.5,135,2.9,95,2,40,0.8,2225,47.2
E02002258,7288,100,4419,60.6,4255,58.4,164,2.3,122,1.7,92,1.3,30,0.4,2747,37.7
E02002259,5793,100,3408,58.8,3236,55.9,172,3,106,1.8,88,1.5,18,0.3,2279,39.3
E02002260,7526,100,4627,61.5,4406,58.5,221,2.9,81,1.1,55,0.7,26,0.3,2818,37.4
E02002261,6482,100,3911,60.3,3725,57.5,186,2.9,109,1.7,81,1.2,28,0.4,2462,38
E02002262,6437,100,3641,56.6,3467,53.9,174,2.7,86,1.3,68,1.1,18,0.3,2710,42.1
E02002263,5199,100,3084,59.3,2946,56.7,138,2.7,55,1.1,43,0.8,12,0.2,2060,39.6
E02002264,5733,100,3248,56.7,3165,55.2,83,1.4,83,1.4,72,1.3,11,0.2,2402,41.9
E02002265,4660,100,2707,58.1,2583,55.4,124,2.7,77,1.7,66,1.4,11,0.2,1876,40.3
E02002266,4783,100,2713,56.7,2614,54.7,99,2.1,50,1,43,0.9,7,0.1,2020,42.2
E02002267,6542,100,3710,56.7,3553,54.3,157,2.4,94,1.4,86,1.3,8,0.1,2738,41.9
E02002268,8309,100,4838,58.2,4619,55.6,219,2.6,146,1.8,114,1.4,32,0.4,3325,40
E02002269,7697,100,4725,61.4,4576,59.5,149,1.9,133,1.7,102,1.3,31,0.4,2839,36.9
E02002270,6937,100,4357,62.8,4236,61.1,121,1.7,114,1.6,94,1.4,20,0.3,2466,35.5
E02002271,6103,100,3809,62.4,3694,60.5,115,1.9,110,1.8,84,1.4,26,0.4,2184,35.8
E02002272,7716,100,4729,61.3,4525,58.6,204,2.6,97,1.3,76,1,21,0.3,2890,37.5
E02002273,5387,100,3394,63,3293,61.1,101,1.9,94,1.7,74,1.4,20,0.4,1899,35.3
E02002274,5532,100,3398,61.4,3285,59.4,113,2,89,1.6,63,1.1,26,0.5,2045,37
E02002275,7005,100,4206,60,4011,57.3,195,2.8,108,1.5,81,1.2,27,0.4,2691,38.4
E02002276,6062,100,3560,58.7,3390,55.9,170,2.8,106,1.7,69,1.1,37,0.6,2396,39.5
E02002277,5369,100,3023,56.3,2840,52.9,183,3.4,97,1.8,76,1.4,21,0.4,2249,41.9
E02002278,5316,100,3134,59,2978,56,156,2.9,99,1.9,77,1.4,22,0.4,2083,39.2
E02002279,4997,100,2895,57.9,2740,54.8,155,3.1,70,1.4,46,0.9,24,0.5,2032,40.7
E02002280,5284,100,2641,50,2442,46.2,199,3.8,117,2.2,77,1.5,40,0.8,2526,47.8
E02002281,9016,100,4916,54.5,4644,51.5,272,3,144,1.6,111,1.2,33,0.4,3956,43.9
E02002282,5582,100,3097,55.5,2871,51.4,226,4,136,2.4,105,1.9,31,0.6,2349,42.1
E02002283,5621,100,2864,51,2659,47.3,205,3.6,146,2.6,98,1.7,48,0.9,2611,46.5
E02002284,5070,100,3005,59.3,2856,56.3,149,2.9,99,2,76,1.5,23,0.5,1966,38.8
E02002285,6529,100,3863,59.2,3738,57.3,125,1.9,101,1.5,73,1.1,28,0.4,2565,39.3
E02002286,4714,100,2578,54.7,2437,51.7,141,3,85,1.8,64,1.4,21,0.4,2051,43.5
E02002287,5621,100,3082,54.8,2839,50.5,243,4.3,116,2.1,101,1.8,15,0.3,2423,43.1
E02002288,7885,100,4715,59.8,4478,56.8,237,3,139,1.8,100,1.3,39,0.5,3031,38.4
E02002289,5055,100,2571,50.9,2369,46.9,202,4,122,2.4,103,2,19,0.4,2362,46.7
E02002290,5224,100,2940,56.3,2842,54.4,98,1.9,89,1.7,71,1.4,18,0.3,2195,42
E02002291,5316,100,3089,58.1,2975,56,114,2.1,100,1.9,83,1.6,17,0.3,2127,40
E02002292,4626,100,2576,55.7,2473,53.5,103,2.2,88,1.9,63,1.4,25,0.5,1962,42.4
E02002293,6281,100,3049,48.5,2731,43.5,318,5.1,142,2.3,104,1.7,38,0.6,3090,49.2
E02002294,8412,100,4066,48.3,3766,44.8,300,3.6,231,2.7,155,1.8,76,0.9,4115,48.9
E02002295,5408,100,2977,55,2722,50.3,255,4.7,162,3,109,2,53,1,2269,42
E02002296,5823,100,3274,56.2,3153,54.1,121,2.1,100,1.7,78,1.3,22,0.4,2449,42.1
E02002297,5705,100,3148,55.2,3007,52.7,141,2.5,105,1.8,84,1.5,21,0.4,2452,43
E02002298,5417,100,2979,55,2832,52.3,147,2.7,68,1.3,46,0.8,22,0.4,2370,43.8
E02002299,5565,100,2637,47.4,2317,41.6,320,5.8,322,5.8,207,3.7,115,2.1,2606,46.8
E02002300,6871,100,4130,60.1,4016,58.4,114,1.7,126,1.8,87,1.3,39,0.6,2615,38.1
E02002301,6112,100,3229,52.8,2929,47.9,300,4.9,191,3.1,139,2.3,52,0.9,2692,44
E02002302,5027,100,3027,60.2,2942,58.5,85,1.7,92,1.8,68,1.4,24,0.5,1908,38
E02002303,5360,100,3131,58.4,2999,56,132,2.5,98,1.8,75,1.4,23,0.4,2131,39.8
E02002304,5562,100,2994,53.8,2782,50,212,3.8,342,6.1,243,4.4,99,1.8,2226,40
E02002305,4845,100,2639,54.5,2434,50.2,205,4.2,156,3.2,122,2.5,34,0.7,2050,42.3
E02002306,5210,100,3110,59.7,3028,58.1,82,1.6,92,1.8,73,1.4,19,0.4,2008,38.5
E02002307,4788,100,2671,55.8,2534,52.9,137,2.9,103,2.2,87,1.8,16,0.3,2014,42.1
E02002308,5529,100,3470,62.8,3334,60.3,136,2.5,103,1.9,73,1.3,30,0.5,1956,35.4
E02002309,5409,100,2634,48.7,2399,44.4,235,4.3,256,4.7,184,3.4,72,1.3,2519,46.6
E02002310,4692,100,2696,57.5,2550,54.3,146,3.1,117,2.5,83,1.8,34,0.7,1879,40
E02002311,5268,100,3109,59,2969,56.4,140,2.7,74,1.4,57,1.1,17,0.3,2085,39.6
E02002312,6917,100,2711,39.2,2507,36.2,204,2.9,873,12.6,509,7.4,364,5.3,3333,48.2
E02002313,5771,100,2647,45.9,2353,40.8,294,5.1,207,3.6,129,2.2,78,1.4,2917,50.5
E02002314,4836,100,2530,52.3,2410,49.8,120,2.5,77,1.6,50,1,27,0.6,2229,46.1
E02002315,5422,100,3435,63.4,3232,59.6,203,3.7,81,1.5,54,1,27,0.5,1906,35.2
E02002316,5603,100,3305,59,3181,56.8,124,2.2,72,1.3,60,1.1,12,0.2,2226,39.7
E02002317,5669,100,2965,52.3,2766,48.8,199,3.5,124,2.2,92,1.6,32,0.6,2580,45.5
E02002318,5103,100,2608,51.1,2442,47.9,166,3.3,137,2.7,97,1.9,40,0.8,2358,46.2
E02002319,5663,100,3602,63.6,3492,61.7,110,1.9,117,2.1,94,1.7,23,0.4,1944,34.3
E02002320,5113,100,2715,53.1,2592,50.7,123,2.4,76,1.5,58,1.1,18,0.4,2322,45.4
E02002321,5740,100,2932,51.1,2840,49.5,92,1.6,254,4.4,141,2.5,113,2,2554,44.5
E02002322,5262,100,3113,59.2,3002,57.1,111,2.1,65,1.2,47,0.9,18,0.3,2084,39.6
E02002323,6821,100,3819,56,3729,54.7,90,1.3,107,1.6,89,1.3,18,0.3,2895,42.4
E02002324,5472,100,3087,56.4,3005,54.9,82,1.5,73,1.3,52,1,21,0.4,2312,42.3
E02002325,7433,100,4299,57.8,4135,55.6,164,2.2,119,1.6,92,1.2,27,0.4,3015,40.6
E02002326,4892,100,2982,61,2906,59.4,76,1.6,93,1.9,72,1.5,21,0.4,1817,37.1
E02002327,8329,100,4846,58.2,4733,56.8,113,1.4,125,1.5,100,1.2,25,0.3,3358,40.3
E02002328,5859,100,3391,57.9,3287,56.1,104,1.8,90,1.5,62,1.1,28,0.5,2378,40.6
E02002329,10063,100,6069,60.3,5886,58.5,183,1.8,151,1.5,114,1.1,37,0.4,3843,38.2
E02002330,5878,100,3061,52.1,2963,50.4,98,1.7,95,1.6,76,1.3,19,0.3,2722,46.3
E02002331,6365,100,3032,47.6,2919,45.9,113,1.8,77,1.2,57,0.9,20,0.3,3256,51.2
E02002332,5300,100,3065,57.8,2947,55.6,118,2.2,82,1.5,53,1,29,0.5,2153,40.6
E02002333,6597,100,3781,57.3,3671,55.6,110,1.7,107,1.6,88,1.3,19,0.3,2709,41.1
E02002334,6213,100,3468,55.8,3390,54.6,78,1.3,108,1.7,78,1.3,30,0.5,2637,42.4
E02002335,6161,100,3522,57.2,3440,55.8,82,1.3,64,1,52,0.8,12,0.2,2575,41.8
E02002336,5685,100,3268,57.5,3182,56,86,1.5,92,1.6,66,1.2,26,0.5,2325,40.9
E02002337,6252,100,3927,62.8,3862,61.8,65,1,95,1.5,75,1.2,20,0.3,2230,35.7
E02002338,5850,100,3549,60.7,3431,58.6,118,2,102,1.7,74,1.3,28,0.5,2199,37.6
E02002339,4571,100,2749,60.1,2612,57.1,137,3,96,2.1,70,1.5,26,0.6,1726,37.8
E02002340,4965,100,2914,58.7,2827,56.9,87,1.8,67,1.3,48,1,19,0.4,1984,40
E02002341,5978,100,3466,58,3367,56.3,99,1.7,104,1.7,75,1.3,29,0.5,2408,40.3
E02002342,4979,100,2854,57.3,2751,55.3,103,2.1,73,1.5,49,1,24,0.5,2052,41.2
E02002343,4808,100,3154,65.6,3058,63.6,96,2,89,1.9,70,1.5,19,0.4,1565,32.5
E02002344,6338,100,3793,59.8,3644,57.5,149,2.4,96,1.5,67,1.1,29,0.5,2449,38.6
E02002345,5094,100,2919,57.3,2808,55.1,111,2.2,74,1.5,59,1.2,15,0.3,2101,41.2
E02002346,4910,100,2936,59.8,2799,57,137,2.8,74,1.5,57,1.2,17,0.3,1900,38.7
E02002347,4886,100,2693,55.1,2512,51.4,181,3.7,89,1.8,65,1.3,24,0.5,2104,43.1
E02002348,5261,100,2968,56.4,2840,54,128,2.4,107,2,75,1.4,32,0.6,2186,41.6
E02002349,4744,100,2999,63.2,2900,61.1,99,2.1,78,1.6,61,1.3,17,0.4,1667,35.1
E02002350,5422,100,2889,53.3,2817,52,72,1.3,237,4.4,136,2.5,101,1.9,2296,42.3
E02002351,4634,100,2669,57.6,2596,56,73,1.6,64,1.4,44,0.9,20,0.4,1901,41
E02002352,6321,100,3959,62.6,3833,60.6,126,2,106,1.7,85,1.3,21,0.3,2256,35.7
E02002353,4734,100,3070,64.9,2977,62.9,93,2,93,2,76,1.6,17,0.4,1571,33.2
E02002354,6500,100,3905,60.1,3722,57.3,183,2.8,108,1.7,73,1.1,35,0.5,2487,38.3
E02002356,7274,100,4860,66.8,4747,65.3,113,1.6,115,1.6,94,1.3,21,0.3,2299,31.6
E02002357,6718,100,4275,63.6,4117,61.3,158,2.4,127,1.9,96,1.4,31,0.5,2316,34.5
E02002358,6802,100,4161,61.2,3978,58.5,183,2.7,105,1.5,72,1.1,33,0.5,2536,37.3
E02002359,5392,100,3092,57.3,2988,55.4,104,1.9,70,1.3,51,0.9,19,0.4,2230,41.4
E02002360,5621,100,3726,66.3,3597,64,129,2.3,118,2.1,87,1.5,31,0.6,1777,31.6
E02002361,4707,100,3019,64.1,2864,60.8,155,3.3,78,1.7,56,1.2,22,0.5,1610,34.2
E02002362,6419,100,3763,58.6,3508,54.7,255,4,91,1.4,64,1,27,0.4,2565,40
E02002363,6155,100,4311,70,4175,67.8,136,2.2,104,1.7,91,1.5,13,0.2,1740,28.3
E02002364,4715,100,2469,52.4,2237,47.4,232,4.9,63,1.3,44,0.9,19,0.4,2183,46.3
E02002366,6616,100,3751,56.7,3575,54,176,2.7,166,2.5,110,1.7,56,0.8,2699,40.8
E02002367,4961,100,2899,58.4,2662,53.7,237,4.8,123,2.5,99,2,24,0.5,1939,39.1
E02002368,6947,100,4601,66.2,4495,64.7,106,1.5,112,1.6,87,1.3,25,0.4,2234,32.2
E02002369,6009,100,3521,58.6,3263,54.3,258,4.3,130,2.2,87,1.4,43,0.7,2358,39.2
E02002370,5458,100,3326,60.9,3125,57.3,201,3.7,87,1.6,57,1,30,0.5,2045,37.5
E02002371,8422,100,4908,58.3,4419,52.5,489,5.8,259,3.1,158,1.9,101,1.2,3255,38.6
E02002373,8153,100,2742,33.6,2560,31.4,182,2.2,1811,22.2,1294,15.9,517,6.3,3600,44.2
E02002374,5823,100,3590,61.7,3401,58.4,189,3.2,287,4.9,208,3.6,79,1.4,1946,33.4
E02002375,5081,100,2795,55,2580,50.8,215,4.2,230,4.5,138,2.7,92,1.8,2056,40.5
E02002376,5603,100,3057,54.6,2755,49.2,302,5.4,175,3.1,113,2,62,1.1,2371,42.3
E02002377,5590,100,2811,50.3,2504,44.8,307,5.5,235,4.2,152,2.7,83,1.5,2544,45.5
E02002379,4366,100,2545,58.3,2334,53.5,211,4.8,113,2.6,82,1.9,31,0.7,1708,39.1
E02002380,4586,100,2810,61.3,2701,58.9,109,2.4,70,1.5,49,1.1,21,0.5,1706,37.2
E02002381,5203,100,3437,66.1,3288,63.2,149,2.9,63,1.2,44,0.8,19,0.4,1703,32.7
E02002382,4900,100,2574,52.5,2247,45.9,327,6.7,156,3.2,101,2.1,55,1.1,2170,44.3
E02002383,7686,100,1469,19.1,1321,17.2,148,1.9,1642,21.4,1153,15,489,6.4,4575,59.5
E02002384,10253,100,3622,35.3,3252,31.7,370,3.6,1181,11.5,696,6.8,485,4.7,5450,53.2
E02002385,7727,100,3993,51.7,3699,47.9,294,3.8,966,12.5,716,9.3,250,3.2,2768,35.8
E02002386,7769,100,4566,58.8,4404,56.7,162,2.1,123,1.6,98,1.3,25,0.3,3080,39.6
E02002387,4799,100,2986,62.2,2814,58.6,172,3.6,100,2.1,76,1.6,24,0.5,1713,35.7
E02002388,6289,100,3949,62.8,3693,58.7,256,4.1,139,2.2,100,1.6,39,0.6,2201,35
E02002389,5676,100,3078,54.2,2747,48.4,331,5.8,195,3.4,147,2.6,48,0.8,2403,42.3
E02002390,5729,100,3681,64.3,3496,61,185,3.2,112,2,82,1.4,30,0.5,1936,33.8
E02002391,6476,100,4325,66.8,4178,64.5,147,2.3,106,1.6,78,1.2,28,0.4,2045,31.6
E02002392,9492,100,1864,19.6,1703,17.9,161,1.7,1725,18.2,985,10.4,740,7.8,5903,62.2
E02002393,6669,100,3662,54.9,3203,48,459,6.9,218,3.3,151,2.3,67,1,2789,41.8
E02002394,5574,100,3025,54.3,2638,47.3,387,6.9,150,2.7,95,1.7,55,1,2399,43
E02002395,5807,100,3548,61.1,3406,58.7,142,2.4,92,1.6,75,1.3,17,0.3,2167,37.3
E02002396,7517,100,4726,62.9,4423,58.8,303,4,169,2.2,112,1.5,57,0.8,2622,34.9
E02002397,6246,100,3836,61.4,3653,58.5,183,2.9,96,1.5,71,1.1,25,0.4,2314,37
E02002398,6352,100,3695,58.2,3587,56.5,108,1.7,118,1.9,90,1.4,28,0.4,2539,40
E02002399,4912,100,2896,59,2643,53.8,253,5.2,114,2.3,83,1.7,31,0.6,1902,38.7
E02002400,7715,100,4332,56.2,3898,50.5,434,5.6,216,2.8,173,2.2,43,0.6,3167,41
E02002401,4821,100,2740,56.8,2478,51.4,262,5.4,133,2.8,97,2,36,0.7,1948,40.4
E02002402,4894,100,2995,61.2,2918,59.6,77,1.6,80,1.6,65,1.3,15,0.3,1819,37.2
E02002403,5329,100,2961,55.6,2855,53.6,106,2,137,2.6,96,1.8,41,0.8,2231,41.9
E02002404,9069,100,5772,63.6,5379,59.3,393,4.3,435,4.8,283,3.1,152,1.7,2862,31.6
E02002405,7256,100,4439,61.2,4282,59,157,2.2,91,1.3,56,0.8,35,0.5,2726,37.6
E02002406,5982,100,3512,58.7,3426,57.3,86,1.4,93,1.6,57,1,36,0.6,2377,39.7
E02002407,4910,100,2885,58.8,2604,53,281,5.7,105,2.1,75,1.5,30,0.6,1920,39.1
E02002408,6219,100,3861,62.1,3719,59.8,142,2.3,88,1.4,68,1.1,20,0.3,2270,36.5
E02002409,4918,100,2954,60.1,2781,56.5,173,3.5,87,1.8,51,1,36,0.7,1877,38.2
E02002410,5737,100,3573,62.3,3282,57.2,291,5.1,99,1.7,63,1.1,36,0.6,2065,36
E02002411,7278,100,4744,65.2,4376,60.1,368,5.1,261,3.6,194,2.7,67,0.9,2273,31.2
E02002412,5881,100,3908,66.5,3739,63.6,169,2.9,93,1.6,71,1.2,22,0.4,1880,32
E02002414,5051,100,2983,59.1,2696,53.4,287,5.7,176,3.5,131,2.6,45,0.9,1892,37.5
E02002415,5582,100,3013,54,2656,47.6,357,6.4,223,4,163,2.9,60,1.1,2346,42
E02002416,5750,100,3172,55.2,3054,53.1,118,2.1,66,1.1,45,0.8,21,0.4,2512,43.7
E02002417,5914,100,3587,60.7,3484,58.9,103,1.7,81,1.4,65,1.1,16,0.3,2246,38
E02002418,5811,100,3550,61.1,3407,58.6,143,2.5,84,1.4,60,1,24,0.4,2177,37.5
E02002419,6313,100,3674,58.2,3421,54.2,253,4,137,2.2,107,1.7,30,0.5,2502,39.6
E02002420,6403,100,3923,61.3,3700,57.8,223,3.5,165,2.6,113,1.8,52,0.8,2315,36.2
E02002421,4786,100,2675,55.9,2400,50.1,275,5.7,135,2.8,107,2.2,28,0.6,1976,41.3
E02002422,5364,100,3432,64,3320,61.9,112,2.1,100,1.9,72,1.3,28,0.5,1832,34.2
E02002423,4537,100,2630,58,2435,53.7,195,4.3,78,1.7,55,1.2,23,0.5,1829,40.3
E02002424,6214,100,3907,62.9,3754,60.4,153,2.5,90,1.4,75,1.2,15,0.2,2217,35.7
E02002425,7163,100,4272,59.6,4129,57.6,143,2,106,1.5,81,1.1,25,0.3,2785,38.9
E02002426,6404,100,3841,60,3704,57.8,137,2.1,97,1.5,70,1.1,27,0.4,2466,38.5
E02002427,5501,100,3135,57,3001,54.6,134,2.4,80,1.5,55,1,25,0.5,2286,41.6
E02002428,6292,100,4093,65.1,3893,61.9,200,3.2,93,1.5,65,1,28,0.4,2106,33.5
E02002429,6890,100,4328,62.8,4171,60.5,157,2.3,117,1.7,85,1.2,32,0.5,2445,35.5
E02002430,5932,100,3469,58.5,3166,53.4,303,5.1,144,2.4,97,1.6,47,0.8,2319,39.1
E02002431,7140,100,4900,68.6,4705,65.9,195,2.7,136,1.9,106,1.5,30,0.4,2104,29.5
E02002432,6181,100,3849,62.3,3707,60,142,2.3,117,1.9,88,1.4,29,0.5,2215,35.8
E02002433,5813,100,3627,62.4,3451,59.4,176,3,111,1.9,83,1.4,28,0.5,2075,35.7
E02002434,7904,100,5639,71.3,5443,68.9,196,2.5,161,2,123,1.6,38,0.5,2104,26.6
E02002435,6685,100,4355,65.1,4217,63.1,138,2.1,116,1.7,92,1.4,24,0.4,2214,33.1
E02002436,5572,100,3374,60.6,3269,58.7,105,1.9,100,1.8,81,1.5,19,0.3,2098,37.7
E02002437,5104,100,3209,62.9,3141,61.5,68,1.3,85,1.7,61,1.2,24,0.5,1810,35.5
E02006852,10140,100,6049,59.7,5838,57.6,211,2.1,533,5.3,368,3.6,165,1.6,3558,35.1
E02006861,12982,100,3433,26.4,3232,24.9,201,1.5,2372,18.3,1572,12.1,800,6.2,7177,55.3
E02006875,9392,100,3842,40.9,3673,39.1,169,1.8,1108,11.8,635,6.8,473,5,4442,47.3
E02006876,6733,100,4484,66.6,4299,63.8,185,2.7,191,2.8,139,2.1,52,0.8,2058,30.6
E02002438,6867,100,3780,55,3543,51.6,237,3.5,108,1.6,77,1.1,31,0.5,2979,43.4
E02002439,7255,100,4395,60.6,4170,57.5,225,3.1,89,1.2,73,1,16,0.2,2771,38.2
E02002440,6359,100,3487,54.8,3304,52,183,2.9,105,1.7,73,1.1,32,0.5,2767,43.5
E02002441,7920,100,4733,59.8,4501,56.8,232,2.9,113,1.4,78,1,35,0.4,3074,38.8
E02002442,6071,100,3953,65.1,3826,63,127,2.1,93,1.5,77,1.3,16,0.3,2025,33.4
E02002443,5070,100,3262,64.3,3159,62.3,103,2,99,2,72,1.4,27,0.5,1709,33.7
E02002444,5657,100,3662,64.7,3535,62.5,127,2.2,90,1.6,67,1.2,23,0.4,1905,33.7
E02002445,6934,100,4206,60.7,4052,58.4,154,2.2,106,1.5,93,1.3,13,0.2,2622,37.8
E02002446,5045,100,2874,57,2800,55.5,74,1.5,77,1.5,51,1,26,0.5,2094,41.5
E02002447,4971,100,2864,57.6,2750,55.3,114,2.3,60,1.2,41,0.8,19,0.4,2047,41.2
E02002448,6469,100,3694,57.1,3521,54.4,173,2.7,75,1.2,52,0.8,23,0.4,2700,41.7
E02002449,7913,100,5099,64.4,4930,62.3,169,2.1,111,1.4,86,1.1,25,0.3,2703,34.2
E02002450,6453,100,4182,64.8,4025,62.4,157,2.4,90,1.4,63,1,27,0.4,2181,33.8
E02002451,6661,100,3896,58.5,3781,56.8,115,1.7,90,1.4,56,0.8,34,0.5,2675,40.2
E02002452,7548,100,4541,60.2,4329,57.4,212,2.8,101,1.3,90,1.2,11,0.1,2906,38.5
E02002453,7860,100,4703,59.8,4487,57.1,216,2.7,123,1.6,91,1.2,32,0.4,3034,38.6
E02002454,7520,100,4614,61.4,4289,57,325,4.3,160,2.1,115,1.5,45,0.6,2746,36.5
E02002455,5044,100,2820,55.9,2649,52.5,171,3.4,81,1.6,65,1.3,16,0.3,2143,42.5
E02002456,6678,100,3855,57.7,3651,54.7,204,3.1,119,1.8,91,1.4,28,0.4,2704,40.5
E02002457,6155,100,3314,53.8,3078,50,236,3.8,118,1.9,83,1.3,35,0.6,2723,44.2
E02002458,7396,100,4418,59.7,4252,57.5,166,2.2,110,1.5,91,1.2,19,0.3,2868,38.8
E02002459,7935,100,4913,61.9,4681,59,232,2.9,135,1.7,107,1.3,28,0.4,2887,36.4
E02002460,6259,100,3443,55,3327,53.2,116,1.9,88,1.4,70,1.1,18,0.3,2728,43.6
E02002461,9557,100,6022,63,5812,60.8,210,2.2,132,1.4,105,1.1,27,0.3,3403,35.6
E02002462,6139,100,3490,56.8,3374,55,116,1.9,110,1.8,81,1.3,29,0.5,2539,41.4
E02002463,7757,100,4446,57.3,4133,53.3,313,4,149,1.9,109,1.4,40,0.5,3162,40.8
E02002464,7260,100,4280,59,4051,55.8,229,3.2,92,1.3,69,1,23,0.3,2888,39.8
E02002465,5276,100,2868,54.4,2745,52,123,2.3,87,1.6,65,1.2,22,0.4,2321,44
E02002466,7475,100,4262,57,4095,54.8,167,2.2,139,1.9,99,1.3,40,0.5,3074,41.1
E02002467,7172,100,4353,60.7,4016,56,337,4.7,117,1.6,87,1.2,30,0.4,2702,37.7
E02002468,5111,100,3034,59.4,2925,57.2,109,2.1,64,1.3,51,1,13,0.3,2013,39.4
E02002469,5347,100,3185,59.6,3091,57.8,94,1.8,86,1.6,63,1.2,23,0.4,2076,38.8
E02002470,5176,100,2617,50.6,2559,49.4,58,1.1,60,1.2,41,0.8,19,0.4,2499,48.3
E02002471,9570,100,5587,58.4,5450,56.9,137,1.4,143,1.5,104,1.1,39,0.4,3840,40.1
E02002472,4909,100,2747,56,2677,54.5,70,1.4,79,1.6,57,1.2,22,0.4,2083,42.4
E02002473,5682,100,3358,59.1,3251,57.2,107,1.9,65,1.1,41,0.7,24,0.4,2259,39.8
E02002474,5541,100,3331,60.1,3151,56.9,180,3.2,84,1.5,58,1,26,0.5,2126,38.4
E02002475,5247,100,2916,55.6,2837,54.1,79,1.5,66,1.3,49,0.9,17,0.3,2265,43.2
E02002476,5213,100,2966,56.9,2805,53.8,161,3.1,70,1.3,48,0.9,22,0.4,2177,41.8
E02002477,5112,100,2822,55.2,2689,52.6,133,2.6,80,1.6,55,1.1,25,0.5,2210,43.2
E02002478,5024,100,3123,62.2,3001,59.7,122,2.4,64,1.3,40,0.8,24,0.5,1837,36.6
E02002479,6816,100,3573,52.4,3425,50.2,148,2.2,105,1.5,61,0.9,44,0.6,3138,46
E02002480,4642,100,2456,52.9,2351,50.6,105,2.3,62,1.3,38,0.8,24,0.5,2124,45.8
E02002481,5932,100,3500,59,3376,56.9,124,2.1,94,1.6,65,1.1,29,0.5,2338,39.4
E02002482,5549,100,3132,56.4,2965,53.4,167,3,96,1.7,78,1.4,18,0.3,2321,41.8
E02002796,5048,100,2760,54.7,2678,53.1,82,1.6,96,1.9,71,1.4,25,0.5,2192,43.4
E02002797,6260,100,3101,49.5,3024,48.3,77,1.2,114,1.8,84,1.3,30,0.5,3045,48.6
E02002798,8742,100,5594,64,5420,62,174,2,221,2.5,183,2.1,38,0.4,2927,33.5
E02002799,4978,100,3050,61.3,2915,58.6,135,2.7,187,3.8,159,3.2,28,0.6,1741,35
E02002800,5816,100,3245,55.8,3143,54,102,1.8,204,3.5,167,2.9,37,0.6,2367,40.7
E02002801,6080,100,3599,59.2,3463,57,136,2.2,89,1.5,58,1,31,0.5,2392,39.3
E02002802,6089,100,3455,56.7,3192,52.4,263,4.3,100,1.6,69,1.1,31,0.5,2534,41.6
E02002803,7487,100,3200,42.7,2988,39.9,212,2.8,971,13,640,8.5,331,4.4,3316,44.3
E02002804,7054,100,4203,59.6,4022,57,181,2.6,159,2.3,123,1.7,36,0.5,2692,38.2
E02002805,4739,100,2525,53.3,2446,51.6,79,1.7,64,1.4,48,1,16,0.3,2150,45.4
E02002806,5554,100,2826,50.9,2639,47.5,187,3.4,671,12.1,532,9.6,139,2.5,2057,37
E02002807,7255,100,4308,59.4,4096,56.5,212,2.9,115,1.6,80,1.1,35,0.5,2832,39
E02002808,10520,100,6112,58.1,5626,53.5,486,4.6,853,8.1,629,6,224,2.1,3555,33.8
E02002809,5696,100,3235,56.8,3123,54.8,112,2,95,1.7,73,1.3,22,0.4,2366,41.5
E02002810,7507,100,4329,57.7,4191,55.8,138,1.8,118,1.6,93,1.2,25,0.3,3060,40.8
E02002811,8300,100,4148,50,3701,44.6,447,5.4,232,2.8,187,2.3,45,0.5,3920,47.2
E02002812,6414,100,3627,56.5,3467,54.1,160,2.5,150,2.3,109,1.7,41,0.6,2637,41.1
E02002813,8589,100,4493,52.3,4047,47.1,446,5.2,199,2.3,146,1.7,53,0.6,3897,45.4
E02002814,6085,100,3229,53.1,3134,51.5,95,1.6,100,1.6,81,1.3,19,0.3,2756,45.3
E02002815,6376,100,3308,51.9,3040,47.7,268,4.2,190,3,151,2.4,39,0.6,2878,45.1
E02002816,7372,100,4531,61.5,4364,59.2,167,2.3,185,2.5,142,1.9,43,0.6,2656,36
E02002817,5153,100,2792,54.2,2674,51.9,118,2.3,102,2,80,1.6,22,0.4,2259,43.8
E02002818,6287,100,3303,52.5,2988,47.5,315,5,159,2.5,114,1.8,45,0.7,2825,44.9
E02002819,6216,100,3782,60.8,3568,57.4,214,3.4,118,1.9,88,1.4,30,0.5,2316,37.3
E02002820,7758,100,4726,60.9,4424,57,302,3.9,195,2.5,158,2,37,0.5,2837,36.6
E02002821,9139,100,5433,59.4,4958,54.3,475,5.2,192,2.1,153,1.7,39,0.4,3514,38.5
E02002822,5489,100,3162,57.6,3014,54.9,148,2.7,110,2,80,1.5,30,0.5,2217,40.4
E02002823,6258,100,3364,53.8,3178,50.8,186,3,105,1.7,71,1.1,34,0.5,2789,44.6
E02002824,8251,100,4662,56.5,4355,52.8,307,3.7,177,2.1,137,1.7,40,0.5,3412,41.4
E02002825,7019,100,4163,59.3,3991,56.9,172,2.5,123,1.8,93,1.3,30,0.4,2733,38.9
E02002826,5655,100,3559,62.9,3432,60.7,127,2.2,126,2.2,101,1.8,25,0.4,1970,34.8
E02002827,5315,100,3316,62.4,3111,58.5,205,3.9,119,2.2,85,1.6,34,0.6,1880,35.4
E02002828,6781,100,3923,57.9,3727,55,196,2.9,138,2,103,1.5,35,0.5,2720,40.1
E02002829,8792,100,4936,56.1,4553,51.8,383,4.4,232,2.6,173,2,59,0.7,3624,41.2
E02002830,8163,100,4849,59.4,4508,55.2,341,4.2,213,2.6,152,1.9,61,0.7,3101,38
E02002831,5811,100,3116,53.6,2915,50.2,201,3.5,139,2.4,110,1.9,29,0.5,2556,44
E02002832,8447,100,4385,51.9,4121,48.8,264,3.1,192,2.3,126,1.5,66,0.8,3870,45.8
E02002833,7276,100,4048,55.6,3789,52.1,259,3.6,162,2.2,114,1.6,48,0.7,3066,42.1
E02002834,9711,100,5904,60.8,5631,58,273,2.8,366,3.8,242,2.5,124,1.3,3441,35.4
E02002836,9182,100,5060,55.1,4767,51.9,293,3.2,179,1.9,134,1.5,45,0.5,3943,42.9
E02002837,7436,100,4152,55.8,3812,51.3,340,4.6,211,2.8,158,2.1,53,0.7,3073,41.3
E02002838,6192,100,3277,52.9,2996,48.4,281,4.5,179,2.9,125,2,54,0.9,2736,44.2
E02002839,6580,100,3902,59.3,3683,56,219,3.3,138,2.1,95,1.4,43,0.7,2540,38.6
E02002842,6759,100,4369,64.6,4044,59.8,325,4.8,309,4.6,223,3.3,86,1.3,2081,30.8
E02002843,12118,100,6673,55.1,6290,51.9,383,3.2,318,2.6,236,1.9,82,0.7,5127,42.3
E02002844,9100,100,4282,47.1,3896,42.8,386,4.2,276,3,199,2.2,77,0.8,4542,49.9
E02002845,8515,100,4550,53.4,4180,49.1,370,4.3,201,2.4,133,1.6,68,0.8,3764,44.2
E02002846,6206,100,3937,63.4,3770,60.7,167,2.7,109,1.8,81,1.3,28,0.5,2160,34.8
E02002847,8199,100,4483,54.7,4185,51,298,3.6,282,3.4,211,2.6,71,0.9,3434,41.9
E02002848,8414,100,3970,47.2,3628,43.1,342,4.1,363,4.3,231,2.7,132,1.6,4081,48.5
E02002849,11992,100,5869,48.9,5432,45.3,437,3.6,1234,10.3,789,6.6,445,3.7,4889,40.8
E02002851,7053,100,3851,54.6,3647,51.7,204,2.9,149,2.1,123,1.7,26,0.4,3053,43.3
E02002852,5314,100,2834,53.3,2588,48.7,246,4.6,131,2.5,89,1.7,42,0.8,2349,44.2
E02002853,10385,100,5270,50.7,4926,47.4,344,3.3,508,4.9,356,3.4,152,1.5,4607,44.4
E02002854,6466,100,3685,57,3425,53,260,4,205,3.2,140,2.2,65,1,2576,39.8
E02002855,6735,100,3990,59.2,3716,55.2,274,4.1,447,6.6,319,4.7,128,1.9,2298,34.1
E02002856,9984,100,4913,49.2,4631,46.4,282,2.8,734,7.4,511,5.1,223,2.2,4337,43.4
E02002857,5782,100,3672,63.5,3461,59.9,211,3.6,190,3.3,141,2.4,49,0.8,1920,33.2
E02002858,6014,100,3604,59.9,3489,58,115,1.9,109,1.8,81,1.3,28,0.5,2301,38.3
E02002860,6779,100,4006,59.1,3828,56.5,178,2.6,125,1.8,83,1.2,42,0.6,2648,39.1
E02002861,6040,100,3133,51.9,2824,46.8,309,5.1,144,2.4,98,1.6,46,0.8,2763,45.7
E02002862,6528,100,3651,55.9,3390,51.9,261,4,120,1.8,77,1.2,43,0.7,2757,42.2
E02006815,8713,100,5011,57.5,4707,54,304,3.5,158,1.8,114,1.3,44,0.5,3544,40.7
E02006817,7460,100,3862,51.8,3625,48.6,237,3.2,421,5.6,271,3.6,150,2,3177,42.6
E02006819,6381,100,3490,54.7,3226,50.6,264,4.1,150,2.4,115,1.8,35,0.5,2741,43
E02006850,9357,100,2524,27,2259,24.1,265,2.8,1675,17.9,911,9.7,764,8.2,5158,55.1
E02006851,9604,100,3193,33.2,2922,30.4,271,2.8,1755,18.3,1047,10.9,708,7.4,4656,48.5
E02006964,4913,100,3351,68.2,3158,64.3,193,3.9,131,2.7,101,2.1,30,0.6,1431,29.1
E02006965,6534,100,3878,59.4,3673,56.2,205,3.1,151,2.3,116,1.8,35,0.5,2505,38.3
E02002863,7653,100,4183,54.7,4071,53.2,112,1.5,109,1.4,93,1.2,16,0.2,3361,43.9
E02002864,6784,100,4057,59.8,3957,58.3,100,1.5,113,1.7,92,1.4,21,0.3,2614,38.5
E02002865,6586,100,3400,51.6,3271,49.7,129,2,86,1.3,78,1.2,8,0.1,3100,47.1
E02002866,6225,100,3537,56.8,3442,55.3,95,1.5,65,1,57,0.9,8,0.1,2623,42.1
E02002867,7049,100,3806,54,3675,52.1,131,1.9,67,1,44,0.6,23,0.3,3176,45.1
E02002868,4904,100,2639,53.8,2513,51.2,126,2.6,77,1.6,57,1.2,20,0.4,2188,44.6
E02002869,5797,100,3235,55.8,2920,50.4,315,5.4,91,1.6,62,1.1,29,0.5,2471,42.6
E02002871,6411,100,3690,57.6,3490,54.4,200,3.1,107,1.7,88,1.4,19,0.3,2614,40.8
E02002872,6725,100,3731,55.5,3409,50.7,322,4.8,122,1.8,95,1.4,27,0.4,2872,42.7
E02002873,7125,100,4342,60.9,3992,56,350,4.9,164,2.3,112,1.6,52,0.7,2619,36.8
E02002874,6511,100,3623,55.6,3399,52.2,224,3.4,118,1.8,96,1.5,22,0.3,2770,42.5
E02002875,6497,100,3950,60.8,3663,56.4,287,4.4,136,2.1,102,1.6,34,0.5,2411,37.1
E02002876,6469,100,3670,56.7,3448,53.3,222,3.4,178,2.8,114,1.8,64,1,2621,40.5
E02002877,6516,100,4104,63,3913,60.1,191,2.9,141,2.2,112,1.7,29,0.4,2271,34.9
E02002878,6338,100,3636,57.4,3315,52.3,321,5.1,191,3,150,2.4,41,0.6,2511,39.6
E02002879,7862,100,4927,62.7,4621,58.8,306,3.9,271,3.4,187,2.4,84,1.1,2664,33.9
E02002880,6276,100,3714,59.2,3316,52.8,398,6.3,209,3.3,135,2.2,74,1.2,2353,37.5
E02002881,5232,100,2953,56.4,2778,53.1,175,3.3,140,2.7,106,2,34,0.6,2139,40.9
E02002882,7568,100,4371,57.8,4107,54.3,264,3.5,422,5.6,322,4.3,100,1.3,2775,36.7
E02002883,6138,100,3735,60.9,3476,56.6,259,4.2,128,2.1,96,1.6,32,0.5,2275,37.1
E02002884,5867,100,3191,54.4,2881,49.1,310,5.3,262,4.5,205,3.5,57,1,2414,41.1
E02002885,6579,100,3227,49.1,2866,43.6,361,5.5,373,5.7,260,4,113,1.7,2979,45.3
E02002886,7802,100,4288,55,4035,51.7,253,3.2,265,3.4,189,2.4,76,1,3249,41.6
E02002887,5368,100,2537,47.3,2356,43.9,181,3.4,135,2.5,98,1.8,37,0.7,2696,50.2
E02002888,5842,100,3266,55.9,2936,50.3,330,5.6,124,2.1,84,1.4,40,0.7,2452,42
E02002889,10826,100,1707,15.8,1545,14.3,162,1.5,1796,16.6,1061,9.8,735,6.8,7323,67.6
E02002890,10373,100,3159,30.5,2865,27.6,294,2.8,1355,13.1,788,7.6,567,5.5,5859,56.5
E02002891,6664,100,3797,57,3593,53.9,204,3.1,140,2.1,105,1.6,35,0.5,2727,40.9
E02002892,4898,100,2579,52.7,2433,49.7,146,3,114,2.3,84,1.7,30,0.6,2205,45
E02002893,12201,100,3173,26,2847,23.3,326,2.7,1560,12.8,946,7.8,614,5,7468,61.2
E02002895,9120,100,2790,30.6,2648,29,142,1.6,1109,12.2,734,8,375,4.1,5221,57.2
E02002896,7897,100,4712,59.7,4311,54.6,401,5.1,235,3,183,2.3,52,0.7,2950,37.4
E02002897,6341,100,3429,54.1,3274,51.6,155,2.4,137,2.2,93,1.5,44,0.7,2775,43.8
E02002898,10269,100,2025,19.7,1888,18.4,137,1.3,1430,13.9,936,9.1,494,4.8,6814,66.4
E02002901,5081,100,3057,60.2,2946,58,111,2.2,95,1.9,70,1.4,25,0.5,1929,38
E02002902,7766,100,3654,47.1,3427,44.1,227,2.9,428,5.5,253,3.3,175,2.3,3684,47.4
E02002903,4772,100,2574,53.9,2421,50.7,153,3.2,82,1.7,56,1.2,26,0.5,2116,44.3
E02002904,5010,100,2969,59.3,2802,55.9,167,3.3,113,2.3,78,1.6,35,0.7,1928,38.5
E02006834,6031,100,3272,54.3,3007,49.9,265,4.4,122,2,81,1.3,41,0.7,2637,43.7
E02006904,8563,100,4062,47.4,3842,44.9,220,2.6,1053,12.3,663,7.7,390,4.6,3448,40.3
E02006905,6017,100,3435,57.1,3158,52.5,277,4.6,224,3.7,155,2.6,69,1.1,2358,39.2
E02007082,14640,100,5085,34.7,4878,33.3,207,1.4,967,6.6,585,4,382,2.6,8588,58.7
E02005612,6018,100,3715,61.7,3597,59.8,118,2,117,1.9,90,1.5,27,0.4,2186,36.3
E02005613,7521,100,4845,64.4,4669,62.1,176,2.3,111,1.5,75,1,36,0.5,2565,34.1
E02005614,10682,100,7560,70.8,7377,69.1,183,1.7,245,2.3,202,1.9,43,0.4,2877,26.9
E02005615,7610,100,4657,61.2,4452,58.5,205,2.7,141,1.9,113,1.5,28,0.4,2812,37
E02005616,4720,100,2970,62.9,2825,59.9,145,3.1,95,2,73,1.5,22,0.5,1655,35.1
E02005617,8750,100,5460,62.4,5153,58.9,307,3.5,172,2,140,1.6,32,0.4,3118,35.6
E02005629,5378,100,3067,57,2980,55.4,87,1.6,59,1.1,38,0.7,21,0.4,2252,41.9
E02005630,8570,100,4699,54.8,4560,53.2,139,1.6,126,1.5,92,1.1,34,0.4,3745,43.7
E02005631,9154,100,5901,64.5,5722,62.5,179,2,163,1.8,124,1.4,39,0.4,3090,33.8
E02005632,5442,100,3159,58,3079,56.6,80,1.5,71,1.3,58,1.1,13,0.2,2212,40.6
E02005633,8040,100,5042,62.7,4881,60.7,161,2,117,1.5,99,1.2,18,0.2,2881,35.8
E02005634,7499,100,4744,63.3,4590,61.2,154,2.1,143,1.9,98,1.3,45,0.6,2612,34.8
E02005635,7622,100,4869,63.9,4731,62.1,138,1.8,159,2.1,114,1.5,45,0.6,2594,34
E02005636,9856,100,6212,63,5962,60.5,250,2.5,176,1.8,126,1.3,50,0.5,3468,35.2
E02005637,7580,100,4762,62.8,4537,59.9,225,3,120,1.6,96,1.3,24,0.3,2698,35.6
E02005638,8290,100,5019,60.5,4876,58.8,143,1.7,159,1.9,109,1.3,50,0.6,3112,37.5
E02005639,4775,100,2777,58.2,2704,56.6,73,1.5,64,1.3,50,1,14,0.3,1934,40.5
E02005640,9550,100,5912,61.9,5772,60.4,140,1.5,150,1.6,120,1.3,30,0.3,3488,36.5
E02005641,7016,100,4221,60.2,4079,58.1,142,2,110,1.6,84,1.2,26,0.4,2685,38.3
E02005642,6935,100,4327,62.4,4218,60.8,109,1.6,132,1.9,109,1.6,23,0.3,2476,35.7
E02005643,6627,100,3950,59.6,3727,56.2,223,3.4,119,1.8,85,1.3,34,0.5,2558,38.6
E02005644,7301,100,5128,70.2,4863,66.6,265,3.6,134,1.8,109,1.5,25,0.3,2039,27.9
E02005645,10277,100,6459,62.8,6179,60.1,280,2.7,213,2.1,166,1.6,47,0.5,3605,35.1
E02005646,5342,100,3077,57.6,2992,56,85,1.6,107,2,84,1.6,23,0.4,2158,40.4
E02005647,6152,100,3651,59.3,3474,56.5,177,2.9,103,1.7,80,1.3,23,0.4,2398,39
E02005648,7760,100,4932,63.6,4782,61.6,150,1.9,199,2.6,150,1.9,49,0.6,2629,33.9
E02005692,5886,100,3461,58.8,3329,56.6,132,2.2,109,1.9,88,1.5,21,0.4,2316,39.3
E02005693,6757,100,4190,62,3992,59.1,198,2.9,182,2.7,122,1.8,60,0.9,2385,35.3
E02005694,6335,100,3913,61.8,3810,60.1,103,1.6,139,2.2,112,1.8,27,0.4,2283,36
E02005695,8067,100,5685,70.5,5436,67.4,249,3.1,200,2.5,172,2.1,28,0.3,2182,27
E02005696,4870,100,2983,61.3,2817,57.8,166,3.4,101,2.1,77,1.6,24,0.5,1786,36.7
E02005697,6089,100,3587,58.9,3385,55.6,202,3.3,108,1.8,89,1.5,19,0.3,2394,39.3
E02005698,4808,100,2761,57.4,2593,53.9,168,3.5,102,2.1,86,1.8,16,0.3,1945,40.5
E02005699,6612,100,4221,63.8,4014,60.7,207,3.1,170,2.6,133,2,37,0.6,2221,33.6
E02005700,8551,100,5052,59.1,4929,57.6,123,1.4,152,1.8,117,1.4,35,0.4,3347,39.1
E02005701,9260,100,5569,60.1,5415,58.5,154,1.7,120,1.3,82,0.9,38,0.4,3571,38.6
E02006862,5362,100,3326,62,3207,59.8,119,2.2,83,1.5,63,1.2,20,0.4,1953,36.4
E02006863,8886,100,6730,75.7,6562,73.8,168,1.9,226,2.5,182,2,44,0.5,1930,21.7
E02007070,5108,100,3265,63.9,3188,62.4,77,1.5,93,1.8,72,1.4,21,0.4,1750,34.3
E02007071,8141,100,5374,66,5226,64.2,148,1.8,145,1.8,100,1.2,45,0.6,2622,32.2
E02005619,5297,100,3277,61.9,3225,60.9,52,1,62,1.2,43,0.8,19,0.4,1958,37
E02005620,6992,100,4439,63.5,4332,62,107,1.5,136,1.9,104,1.5,32,0.5,2417,34.6
E02005621,7809,100,4002,51.2,3821,48.9,181,2.3,91,1.2,67,0.9,24,0.3,3716,47.6
E02005622,8093,100,5090,62.9,4946,61.1,144,1.8,102,1.3,82,1,20,0.2,2901,35.8
E02005623,9315,100,5906,63.4,5751,61.7,155,1.7,206,2.2,152,1.6,54,0.6,3203,34.4
E02005624,9268,100,6399,69,6211,67,188,2,165,1.8,133,1.4,32,0.3,2704,29.2
E02005625,7774,100,4591,59.1,4415,56.8,176,2.3,156,2,119,1.5,37,0.5,3027,38.9
E02005626,5611,100,3607,64.3,3449,61.5,158,2.8,101,1.8,77,1.4,24,0.4,1903,33.9
E02005627,6323,100,3863,61.1,3728,59,135,2.1,84,1.3,61,1,23,0.4,2376,37.6
E02005628,7087,100,4440,62.6,4294,60.6,146,2.1,105,1.5,81,1.1,24,0.3,2542,35.9
E02005650,5755,100,3340,58,3218,55.9,122,2.1,309,5.4,184,3.2,125,2.2,2106,36.6
E02005651,5439,100,3167,58.2,3082,56.7,85,1.6,80,1.5,61,1.1,19,0.3,2192,40.3
E02005652,5590,100,3219,57.6,3120,55.8,99,1.8,113,2,87,1.6,26,0.5,2258,40.4
E02005653,6695,100,4438,66.3,4196,62.7,242,3.6,195,2.9,157,2.3,38,0.6,2062,30.8
E02005654,6628,100,4275,64.5,4061,61.3,214,3.2,170,2.6,119,1.8,51,0.8,2183,32.9
E02005655,5254,100,2948,56.1,2837,54,111,2.1,97,1.8,74,1.4,23,0.4,2209,42
E02005656,4980,100,2985,59.9,2767,55.6,218,4.4,175,3.5,144,2.9,31,0.6,1820,36.5
E02005657,5546,100,3309,59.7,3197,57.6,112,2,139,2.5,112,2,27,0.5,2098,37.8
E02005658,5377,100,3416,63.5,3214,59.8,202,3.8,222,4.1,170,3.2,52,1,1739,32.3
E02005659,4802,100,2865,59.7,2763,57.5,102,2.1,101,2.1,90,1.9,11,0.2,1836,38.2
E02005660,5211,100,3088,59.3,2911,55.9,177,3.4,145,2.8,111,2.1,34,0.7,1978,38
E02005661,5319,100,3378,63.5,3186,59.9,192,3.6,170,3.2,119,2.2,51,1,1771,33.3
E02005662,5490,100,3620,65.9,3463,63.1,157,2.9,161,2.9,140,2.6,21,0.4,1709,31.1
E02005663,4583,100,2936,64.1,2855,62.3,81,1.8,91,2,78,1.7,13,0.3,1556,34
E02005664,5176,100,3234,62.5,3105,60,129,2.5,179,3.5,155,3,24,0.5,1763,34.1
E02005665,6920,100,4502,65.1,4326,62.5,176,2.5,172,2.5,135,2,37,0.5,2246,32.5
E02005666,6769,100,4191,61.9,3877,57.3,314,4.6,233,3.4,184,2.7,49,0.7,2345,34.6
E02005667,5368,100,3150,58.7,3010,56.1,140,2.6,79,1.5,69,1.3,10,0.2,2139,39.8
E02005668,5395,100,3149,58.4,3059,56.7,90,1.7,104,1.9,82,1.5,22,0.4,2142,39.7
E02005669,4987,100,2961,59.4,2884,57.8,77,1.5,90,1.8,65,1.3,25,0.5,1936,38.8
E02005670,7771,100,5076,65.3,4669,60.1,407,5.2,395,5.1,308,4,87,1.1,2300,29.6
E02005671,6553,100,4423,67.5,4233,64.6,190,2.9,302,4.6,251,3.8,51,0.8,1828,27.9
E02005672,7112,100,4831,67.9,4542,63.9,289,4.1,473,6.7,368,5.2,105,1.5,1808,25.4
E02005673,6382,100,4147,65,3961,62.1,186,2.9,188,2.9,151,2.4,37,0.6,2047,32.1
E02005674,7897,100,4692,59.4,4433,56.1,259,3.3,504,6.4,324,4.1,180,2.3,2701,34.2
E02005675,4834,100,3201,66.2,3055,63.2,146,3,129,2.7,115,2.4,14,0.3,1504,31.1
E02005676,4924,100,3195,64.9,3066,62.3,129,2.6,154,3.1,120,2.4,34,0.7,1575,32
E02005677,8239,100,4840,58.7,4645,56.4,195,2.4,651,7.9,429,5.2,222,2.7,2748,33.4
E02005679,7273,100,5156,70.9,5030,69.2,126,1.7,168,2.3,136,1.9,32,0.4,1949,26.8
E02005680,6680,100,4627,69.3,4492,67.2,135,2,191,2.9,151,2.3,40,0.6,1862,27.9
E02005681,7077,100,4158,58.8,4046,57.2,112,1.6,114,1.6,86,1.2,28,0.4,2805,39.6
E02005682,6148,100,3834,62.4,3709,60.3,125,2,116,1.9,93,1.5,23,0.4,2198,35.8
E02005683,11938,100,7931,66.4,7691,64.4,240,2,264,2.2,199,1.7,65,0.5,3743,31.4
E02005684,7171,100,4427,61.7,4300,60,127,1.8,108,1.5,86,1.2,22,0.3,2636,36.8
E02005685,8197,100,5511,67.2,5339,65.1,172,2.1,134,1.6,96,1.2,38,0.5,2552,31.1
E02005686,6701,100,4059,60.6,3960,59.1,99,1.5,132,2,105,1.6,27,0.4,2510,37.5
E02005687,5541,100,3589,64.8,3511,63.4,78,1.4,94,1.7,70,1.3,24,0.4,1858,33.5
E02005688,7883,100,5077,64.4,4925,62.5,152,1.9,125,1.6,88,1.1,37,0.5,2681,34
E02005689,8488,100,6112,72,5990,70.6,122,1.4,165,1.9,132,1.6,33,0.4,2211,26
E02005690,4537,100,2985,65.8,2880,63.5,105,2.3,59,1.3,53,1.2,6,0.1,1493,32.9
E02005691,5722,100,3491,61,3406,59.5,85,1.5,99,1.7,78,1.4,21,0.4,2132,37.3
E02007072,5542,100,4017,72.5,3893,70.2,124,2.2,175,3.2,136,2.5,39,0.7,1350,24.4
E02007073,6054,100,4121,68.1,4014,66.3,107,1.8,134,2.2,94,1.6,40,0.7,1799,29.7
E02004029,6073,100,3560,58.6,3416,56.2,144,2.4,86,1.4,64,1.1,22,0.4,2427,40
E02004030,5158,100,2790,54.1,2706,52.5,84,1.6,47,0.9,33,0.6,14,0.3,2321,45
E02004031,5896,100,3303,56,3089,52.4,214,3.6,63,1.1,52,0.9,11,0.2,2530,42.9
E02004032,7172,100,4114,57.4,3973,55.4,141,2,108,1.5,84,1.2,24,0.3,2950,41.1
E02004033,7528,100,4520,60,4368,58,152,2,98,1.3,79,1,19,0.3,2910,38.7
E02004034,5888,100,3230,54.9,3161,53.7,69,1.2,78,1.3,67,1.1,11,0.2,2580,43.8
E02004035,5569,100,2988,53.7,2906,52.2,82,1.5,81,1.5,66,1.2,15,0.3,2500,44.9
E02004036,8464,100,4860,57.4,4637,54.8,223,2.6,109,1.3,87,1,22,0.3,3495,41.3
E02004037,6560,100,4002,61,3899,59.4,103,1.6,117,1.8,93,1.4,24,0.4,2441,37.2
E02004038,6468,100,3781,58.5,3636,56.2,145,2.2,87,1.3,76,1.2,11,0.2,2600,40.2
E02004039,6501,100,3893,59.9,3802,58.5,91,1.4,108,1.7,91,1.4,17,0.3,2500,38.5
E02004040,7768,100,4911,63.2,4753,61.2,158,2,79,1,64,0.8,15,0.2,2778,35.8
E02004041,6127,100,3725,60.8,3595,58.7,130,2.1,85,1.4,58,0.9,27,0.4,2317,37.8
E02004043,6076,100,3534,58.2,3435,56.5,99,1.6,89,1.5,73,1.2,16,0.3,2453,40.4
E02004044,7351,100,4260,58,4141,56.3,119,1.6,160,2.2,121,1.6,39,0.5,2931,39.9
E02006827,6458,100,3679,57,3490,54,189,2.9,75,1.2,55,0.9,20,0.3,2704,41.9
E02004045,8180,100,4854,59.3,4725,57.8,129,1.6,119,1.5,97,1.2,22,0.3,3207,39.2
E02004046,5189,100,2897,55.8,2814,54.2,83,1.6,71,1.4,49,0.9,22,0.4,2221,42.8
E02004047,4932,100,2723,55.2,2589,52.5,134,2.7,62,1.3,44,0.9,18,0.4,2147,43.5
E02004048,5662,100,3220,56.9,3070,54.2,150,2.6,78,1.4,64,1.1,14,0.2,2364,41.8
E02004049,6715,100,3646,54.3,3556,53,90,1.3,99,1.5,77,1.1,22,0.3,2970,44.2
E02004050,6243,100,3664,58.7,3529,56.5,135,2.2,96,1.5,87,1.4,9,0.1,2483,39.8
E02004051,8050,100,4682,58.2,4530,56.3,152,1.9,127,1.6,105,1.3,22,0.3,3241,40.3
E02004052,7200,100,4352,60.4,4218,58.6,134,1.9,119,1.7,86,1.2,33,0.5,2729,37.9
E02004053,6392,100,3847,60.2,3672,57.4,175,2.7,106,1.7,87,1.4,19,0.3,2439,38.2
E02004054,7717,100,4761,61.7,4601,59.6,160,2.1,129,1.7,99,1.3,30,0.4,2827,36.6
E02004055,5794,100,3253,56.1,3115,53.8,138,2.4,66,1.1,46,0.8,20,0.3,2475,42.7
E02004056,6280,100,3533,56.3,3344,53.2,189,3,122,1.9,84,1.3,38,0.6,2625,41.8
E02004057,6302,100,3939,62.5,3802,60.3,137,2.2,120,1.9,90,1.4,30,0.5,2243,35.6
E02004058,6539,100,3637,55.6,3428,52.4,209,3.2,90,1.4,65,1,25,0.4,2812,43
E02004059,6164,100,3437,55.8,3347,54.3,90,1.5,81,1.3,67,1.1,14,0.2,2646,42.9
E02004060,6116,100,3288,53.8,3163,51.7,125,2,107,1.7,89,1.5,18,0.3,2721,44.5
E02004061,6224,100,3590,57.7,3412,54.8,178,2.9,117,1.9,74,1.2,43,0.7,2517,40.4
E02004062,6470,100,3447,53.3,3294,50.9,153,2.4,99,1.5,79,1.2,20,0.3,2924,45.2
E02004063,6572,100,3667,55.8,3541,53.9,126,1.9,76,1.2,48,0.7,28,0.4,2829,43
E02004064,7897,100,5041,63.8,4816,61,225,2.8,127,1.6,101,1.3,26,0.3,2729,34.6
E02004065,6916,100,3555,51.4,3484,50.4,71,1,82,1.2,53,0.8,29,0.4,3279,47.4
E02004066,9587,100,5638,58.8,5438,56.7,200,2.1,116,1.2,86,0.9,30,0.3,3833,40
E02004067,5149,100,2592,50.3,2417,46.9,175,3.4,67,1.3,53,1,14,0.3,2490,48.4
E02004068,6200,100,3428,55.3,3355,54.1,73,1.2,78,1.3,67,1.1,11,0.2,2694,43.5
E02004069,5513,100,2871,52.1,2780,50.4,91,1.7,81,1.5,65,1.2,16,0.3,2561,46.5
E02004072,7989,100,4325,54.1,4195,52.5,130,1.6,79,1,66,0.8,13,0.2,3585,44.9
E02004073,7519,100,4039,53.7,3881,51.6,158,2.1,65,0.9,50,0.7,15,0.2,3415,45.4
E02004074,4935,100,2707,54.9,2635,53.4,72,1.5,54,1.1,47,1,7,0.1,2174,44.1
E02004075,6166,100,3493,56.6,3392,55,101,1.6,58,0.9,44,0.7,14,0.2,2615,42.4
E02004076,6127,100,3669,59.9,3562,58.1,107,1.7,101,1.6,90,1.5,11,0.2,2357,38.5
E02004077,7049,100,4033,57.2,3873,54.9,160,2.3,81,1.1,65,0.9,16,0.2,2935,41.6
E02007029,9563,100,5070,53,4934,51.6,136,1.4,137,1.4,123,1.3,14,0.1,4356,45.6
E02004078,5625,100,2979,53,2783,49.5,196,3.5,74,1.3,57,1,17,0.3,2572,45.7
E02004080,8070,100,5055,62.6,4773,59.1,282,3.5,103,1.3,82,1,21,0.3,2912,36.1
E02004081,4900,100,2693,55,2605,53.2,88,1.8,75,1.5,60,1.2,15,0.3,2132,43.5
E02004082,5188,100,2852,55,2795,53.9,57,1.1,87,1.7,64,1.2,23,0.4,2249,43.4
E02004083,6751,100,4354,64.5,4176,61.9,178,2.6,121,1.8,99,1.5,22,0.3,2276,33.7
E02004084,4861,100,2744,56.4,2618,53.9,126,2.6,79,1.6,66,1.4,13,0.3,2038,41.9
E02004085,7317,100,4269,58.3,4137,56.5,132,1.8,126,1.7,90,1.2,36,0.5,2922,39.9
E02004086,5976,100,3402,56.9,3279,54.9,123,2.1,87,1.5,69,1.2,18,0.3,2487,41.6
E02004087,6293,100,3957,62.9,3780,60.1,177,2.8,80,1.3,56,0.9,24,0.4,2256,35.8
E02004088,6395,100,3818,59.7,3710,58,108,1.7,110,1.7,81,1.3,29,0.5,2467,38.6
E02004089,5679,100,3698,65.1,3505,61.7,193,3.4,82,1.4,70,1.2,12,0.2,1899,33.4
E02004090,5075,100,2854,56.2,2754,54.3,100,2,70,1.4,59,1.2,11,0.2,2151,42.4
E02004091,7823,100,4994,63.8,4844,61.9,150,1.9,111,1.4,86,1.1,25,0.3,2718,34.7
E02004092,7701,100,4608,59.8,4429,57.5,179,2.3,101,1.3,85,1.1,16,0.2,2992,38.9
E02006828,5876,100,3791,64.5,3663,62.3,128,2.2,109,1.9,94,1.6,15,0.3,1976,33.6
E02004093,5230,100,3350,64.1,3204,61.3,146,2.8,66,1.3,55,1.1,11,0.2,1814,34.7
E02004094,5562,100,3368,60.6,3172,57,196,3.5,75,1.3,62,1.1,13,0.2,2119,38.1
E02004095,8506,100,5295,62.3,5046,59.3,249,2.9,94,1.1,81,1,13,0.2,3117,36.6
E02004096,8162,100,4831,59.2,4711,57.7,120,1.5,135,1.7,108,1.3,27,0.3,3196,39.2
E02004097,6378,100,3985,62.5,3854,60.4,131,2.1,86,1.3,72,1.1,14,0.2,2307,36.2
E02004098,6123,100,3598,58.8,3471,56.7,127,2.1,79,1.3,57,0.9,22,0.4,2446,39.9
E02004100,6795,100,4048,59.6,3950,58.1,98,1.4,99,1.5,86,1.3,13,0.2,2648,39
E02004102,6684,100,3622,54.2,3416,51.1,206,3.1,107,1.6,83,1.2,24,0.4,2955,44.2
E02004103,5435,100,3271,60.2,3120,57.4,151,2.8,77,1.4,62,1.1,15,0.3,2087,38.4
E02004104,5962,100,3742,62.8,3653,61.3,89,1.5,100,1.7,89,1.5,11,0.2,2120,35.6
E02006872,10827,100,6308,58.3,6146,56.8,162,1.5,147,1.4,116,1.1,31,0.3,4372,40.4
E02004105,7699,100,4547,59.1,4376,56.8,171,2.2,122,1.6,92,1.2,30,0.4,3030,39.4
E02004106,5899,100,3106,52.7,3026,51.3,80,1.4,73,1.2,55,0.9,18,0.3,2720,46.1
E02004108,6302,100,3508,55.7,3376,53.6,132,2.1,99,1.6,83,1.3,16,0.3,2695,42.8
E02004109,5713,100,2878,50.4,2812,49.2,66,1.2,96,1.7,72,1.3,24,0.4,2739,47.9
E02004110,6071,100,3445,56.7,3344,55.1,101,1.7,89,1.5,76,1.3,13,0.2,2537,41.8
E02004111,4715,100,2555,54.2,2484,52.7,71,1.5,59,1.3,39,0.8,20,0.4,2101,44.6
E02004112,5493,100,2718,49.5,2657,48.4,61,1.1,71,1.3,47,0.9,24,0.4,2704,49.2
E02004113,8229,100,4621,56.2,4415,53.7,206,2.5,104,1.3,66,0.8,38,0.5,3504,42.6
E02004114,7220,100,4029,55.8,3934,54.5,95,1.3,103,1.4,77,1.1,26,0.4,3088,42.8
E02004115,7526,100,4350,57.8,4206,55.9,144,1.9,111,1.5,92,1.2,19,0.3,3065,40.7
E02004116,7005,100,3854,55,3638,51.9,216,3.1,90,1.3,69,1,21,0.3,3061,43.7
E02004117,6638,100,3675,55.4,3549,53.5,126,1.9,74,1.1,61,0.9,13,0.2,2889,43.5
E02006804,6763,100,3995,59.1,3841,56.8,154,2.3,97,1.4,74,1.1,23,0.3,2671,39.5
E02004118,6331,100,3982,62.9,3870,61.1,112,1.8,110,1.7,95,1.5,15,0.2,2239,35.4
E02004119,9424,100,6340,67.3,6189,65.7,151,1.6,187,2,142,1.5,45,0.5,2897,30.7
E02004120,8759,100,5765,65.8,5568,63.6,197,2.2,129,1.5,95,1.1,34,0.4,2865,32.7
E02004121,7505,100,4789,63.8,4664,62.1,125,1.7,139,1.9,120,1.6,19,0.3,2577,34.3
E02004122,5720,100,3259,57,3193,55.8,66,1.2,97,1.7,70,1.2,27,0.5,2364,41.3
E02004123,5659,100,3318,58.6,3227,57,91,1.6,65,1.1,48,0.8,17,0.3,2276,40.2
E02004124,6149,100,3559,57.9,3431,55.8,128,2.1,126,2,97,1.6,29,0.5,2464,40.1
E02004125,7140,100,4223,59.1,4028,56.4,195,2.7,133,1.9,110,1.5,23,0.3,2784,39
E02004126,6131,100,3526,57.5,3416,55.7,110,1.8,92,1.5,63,1,29,0.5,2513,41
E02004128,9532,100,5691,59.7,5519,57.9,172,1.8,143,1.5,117,1.2,26,0.3,3698,38.8
E02006919,8223,100,5703,69.4,5511,67,192,2.3,151,1.8,119,1.4,32,0.4,2369,28.8
E02006920,6384,100,4277,67,4129,64.7,148,2.3,105,1.6,85,1.3,20,0.3,2002,31.4
E02005334,4882,100,3201,65.6,3114,63.8,87,1.8,98,2,76,1.6,22,0.5,1583,32.4
E02005335,6210,100,3564,57.4,3481,56.1,83,1.3,115,1.9,87,1.4,28,0.5,2531,40.8
E02005336,5723,100,3951,69,3781,66.1,170,3,88,1.5,66,1.2,22,0.4,1684,29.4
E02005337,8108,100,4982,61.4,4746,58.5,236,2.9,157,1.9,117,1.4,40,0.5,2969,36.6
E02005338,9184,100,5930,64.6,5733,62.4,197,2.1,141,1.5,98,1.1,43,0.5,3113,33.9
E02005339,7109,100,4532,63.8,4429,62.3,103,1.4,125,1.8,91,1.3,34,0.5,2452,34.5
E02005340,7370,100,4380,59.4,4220,57.3,160,2.2,149,2,94,1.3,55,0.7,2841,38.5
E02005341,6117,100,4118,67.3,3994,65.3,124,2,108,1.8,83,1.4,25,0.4,1891,30.9
E02005342,6030,100,3647,60.5,3536,58.6,111,1.8,78,1.3,61,1,17,0.3,2305,38.2
E02005343,6483,100,3908,60.3,3810,58.8,98,1.5,93,1.4,66,1,27,0.4,2482,38.3
E02005344,7518,100,4646,61.8,4539,60.4,107,1.4,144,1.9,95,1.3,49,0.7,2728,36.3
E02006820,8922,100,5236,58.7,5046,56.6,190,2.1,110,1.2,78,0.9,32,0.4,3576,40.1
E02005345,5344,100,3186,59.6,3087,57.8,99,1.9,78,1.5,58,1.1,20,0.4,2080,38.9
E02005346,10472,100,5892,56.3,5511,52.6,381,3.6,445,4.2,337,3.2,108,1,4135,39.5
E02005347,10257,100,2881,28.1,2729,26.6,152,1.5,1055,10.3,702,6.8,353,3.4,6321,61.6
E02005348,4820,100,2564,53.2,2468,51.2,96,2,107,2.2,77,1.6,30,0.6,2149,44.6
E02005349,6495,100,3956,60.9,3847,59.2,109,1.7,101,1.6,81,1.2,20,0.3,2438,37.5
E02005350,5843,100,3477,59.5,3346,57.3,131,2.2,83,1.4,71,1.2,12,0.2,2283,39.1
E02005351,10181,100,2396,23.5,2259,22.2,137,1.3,939,9.2,557,5.5,382,3.8,6846,67.2
E02005352,5212,100,3085,59.2,3037,58.3,48,0.9,95,1.8,73,1.4,22,0.4,2032,39
E02005353,8541,100,4880,57.1,4628,54.2,252,3,286,3.3,190,2.2,96,1.1,3375,39.5
E02005354,8437,100,4759,56.4,4615,54.7,144,1.7,199,2.4,130,1.5,69,0.8,3479,41.2
E02005355,6022,100,3672,61,3568,59.2,104,1.7,109,1.8,90,1.5,19,0.3,2241,37.2
E02005356,6044,100,3553,58.8,3451,57.1,102,1.7,88,1.5,72,1.2,16,0.3,2403,39.8
E02005357,6719,100,4415,65.7,4268,63.5,147,2.2,83,1.2,66,1,17,0.3,2221,33.1
E02005358,9820,100,6390,65.1,6215,63.3,175,1.8,163,1.7,120,1.2,43,0.4,3267,33.3
E02005359,6267,100,3884,62,3780,60.3,104,1.7,96,1.5,71,1.1,25,0.4,2287,36.5
E02005360,5377,100,2954,54.9,2906,54,48,0.9,93,1.7,67,1.2,26,0.5,2330,43.3
E02005361,5294,100,3276,61.9,3167,59.8,109,2.1,85,1.6,59,1.1,26,0.5,1933,36.5
E02005362,5869,100,3586,61.1,3464,59,122,2.1,75,1.3,62,1.1,13,0.2,2208,37.6
E02005363,7370,100,4426,60.1,4277,58,149,2,124,1.7,99,1.3,25,0.3,2820,38.3
E02005364,4351,100,2799,64.3,2700,62.1,99,2.3,58,1.3,50,1.1,8,0.2,1494,34.3
E02005365,8097,100,4670,57.7,4487,55.4,183,2.3,113,1.4,86,1.1,27,0.3,3314,40.9
E02005366,6260,100,3880,62,3781,60.4,99,1.6,107,1.7,89,1.4,18,0.3,2273,36.3
E02005368,5404,100,3274,60.6,3196,59.1,78,1.4,76,1.4,63,1.2,13,0.2,2054,38
E02005369,10272,100,6172,60.1,5987,58.3,185,1.8,174,1.7,143,1.4,31,0.3,3926,38.2
E02005370,7813,100,5196,66.5,5087,65.1,109,1.4,129,1.7,105,1.3,24,0.3,2488,31.8
E02005371,8950,100,5565,62.2,5410,60.4,155,1.7,145,1.6,117,1.3,28,0.3,3240,36.2
E02005372,8592,100,5287,61.5,5172,60.2,115,1.3,132,1.5,111,1.3,21,0.2,3173,36.9
E02005373,10118,100,5946,58.8,5788,57.2,158,1.6,153,1.5,128,1.3,25,0.2,4019,39.7
E02005374,5520,100,3142,56.9,3045,55.2,97,1.8,86,1.6,72,1.3,14,0.3,2292,41.5
E02005375,7675,100,4718,61.5,4572,59.6,146,1.9,134,1.7,116,1.5,18,0.2,2823,36.8
E02005376,8852,100,5347,60.4,5185,58.6,162,1.8,172,1.9,141,1.6,31,0.4,3333,37.7
E02006816,7231,100,4387,60.7,4269,59,118,1.6,84,1.2,65,0.9,19,0.3,2760,38.2
E02005377,7417,100,4335,58.4,4215,56.8,120,1.6,99,1.3,72,1,27,0.4,2983,40.2
E02005378,4349,100,2693,61.9,2628,60.4,65,1.5,53,1.2,36,0.8,17,0.4,1603,36.9
E02005379,5011,100,2951,58.9,2859,57.1,92,1.8,70,1.4,56,1.1,14,0.3,1990,39.7
E02005380,7289,100,4161,57.1,4076,55.9,85,1.2,93,1.3,79,1.1,14,0.2,3035,41.6
E02005381,7277,100,4133,56.8,4026,55.3,107,1.5,128,1.8,96,1.3,32,0.4,3016,41.4
E02005382,8752,100,5258,60.1,5043,57.6,215,2.5,109,1.2,88,1,21,0.2,3385,38.7
E02005383,7584,100,4595,60.6,4430,58.4,165,2.2,81,1.1,57,0.8,24,0.3,2908,38.3
E02005384,6179,100,3743,60.6,3646,59,97,1.6,104,1.7,87,1.4,17,0.3,2332,37.7
E02005385,5611,100,3271,58.3,3178,56.6,93,1.7,87,1.6,74,1.3,13,0.2,2253,40.2
E02005386,7615,100,4894,64.3,4655,61.1,239,3.1,95,1.2,74,1,21,0.3,2626,34.5
E02005387,8074,100,5283,65.4,5118,63.4,165,2,125,1.5,104,1.3,21,0.3,2666,33
E02005388,5092,100,3209,63,3085,60.6,124,2.4,69,1.4,49,1,20,0.4,1814,35.6
E02005389,5058,100,2751,54.4,2651,52.4,100,2,81,1.6,63,1.2,18,0.4,2226,44
E02005390,8625,100,5335,61.9,5238,60.7,97,1.1,143,1.7,111,1.3,32,0.4,3147,36.5
E02005391,8144,100,4733,58.1,4609,56.6,124,1.5,106,1.3,86,1.1,20,0.2,3305,40.6
E02005392,7665,100,4673,61,4554,59.4,119,1.6,131,1.7,115,1.5,16,0.2,2861,37.3
E02005393,6203,100,3806,61.4,3711,59.8,95,1.5,85,1.4,67,1.1,18,0.3,2312,37.3
E02005394,7664,100,4683,61.1,4505,58.8,178,2.3,129,1.7,104,1.4,25,0.3,2852,37.2
E02005395,7403,100,4388,59.3,4213,56.9,175,2.4,112,1.5,83,1.1,29,0.4,2903,39.2
E02005396,5861,100,3450,58.9,3354,57.2,96,1.6,68,1.2,61,1,7,0.1,2343,40
E02005397,7745,100,4809,62.1,4665,60.2,144,1.9,100,1.3,76,1,24,0.3,2836,36.6
E02005398,5883,100,3104,52.8,3011,51.2,93,1.6,160,2.7,116,2,44,0.7,2619,44.5
E02005399,6708,100,4265,63.6,4151,61.9,114,1.7,105,1.6,71,1.1,34,0.5,2338,34.9
E02005400,4880,100,2700,55.3,2619,53.7,81,1.7,48,1,43,0.9,5,0.1,2132,43.7
E02005401,5391,100,3211,59.6,3123,57.9,88,1.6,99,1.8,80,1.5,19,0.4,2081,38.6
E02005402,5584,100,3152,56.4,3047,54.6,105,1.9,89,1.6,72,1.3,17,0.3,2343,42
E02005403,5607,100,3319,59.2,3215,57.3,104,1.9,58,1,37,0.7,21,0.4,2230,39.8
E02005404,7126,100,4423,62.1,4276,60,147,2.1,125,1.8,94,1.3,31,0.4,2578,36.2
E02005405,5857,100,3121,53.3,2963,50.6,158,2.7,84,1.4,63,1.1,21,0.4,2652,45.3
E02005406,6320,100,4205,66.5,4023,63.7,182,2.9,89,1.4,73,1.2,16,0.3,2026,32.1
E02005407,8886,100,6140,69.1,5978,67.3,162,1.8,142,1.6,104,1.2,38,0.4,2604,29.3
E02005408,6465,100,4013,62.1,3867,59.8,146,2.3,121,1.9,91,1.4,30,0.5,2331,36.1
E02005409,9704,100,6196,63.8,6000,61.8,196,2,116,1.2,99,1,17,0.2,3392,35
E02005412,7081,100,3751,53,3586,50.6,165,2.3,89,1.3,72,1,17,0.2,3241,45.8
E02005414,6635,100,3743,56.4,3560,53.7,183,2.8,122,1.8,85,1.3,37,0.6,2770,41.7
E02005415,6529,100,3954,60.6,3758,57.6,196,3,93,1.4,63,1,30,0.5,2482,38
E02005416,7590,100,4322,56.9,4166,54.9,156,2.1,109,1.4,71,0.9,38,0.5,3159,41.6
E02006818,6857,100,4020,58.6,3856,56.2,164,2.4,104,1.5,72,1.1,32,0.5,2733,39.9
E02006966,6373,100,2993,47,2893,45.4,100,1.6,289,4.5,167,2.6,122,1.9,3091,48.5
E02006967,6147,100,3730,60.7,3551,57.8,179,2.9,122,2,90,1.5,32,0.5,2295,37.3
E02005417,6467,100,3231,50,3105,48,126,1.9,79,1.2,60,0.9,19,0.3,3157,48.8
E02005418,8629,100,5542,64.2,5258,60.9,284,3.3,143,1.7,109,1.3,34,0.4,2944,34.1
E02005419,7130,100,4864,68.2,4638,65,226,3.2,109,1.5,86,1.2,23,0.3,2157,30.3
E02005420,7116,100,4335,60.9,4120,57.9,215,3,127,1.8,109,1.5,18,0.3,2654,37.3
E02005422,5588,100,3090,55.3,2973,53.2,117,2.1,69,1.2,48,0.9,21,0.4,2429,43.5
E02005423,8493,100,4827,56.8,4654,54.8,173,2,139,1.6,93,1.1,46,0.5,3527,41.5
E02006864,7276,100,4309,59.2,4161,57.2,148,2,111,1.5,77,1.1,34,0.5,2856,39.3
E02006865,6885,100,4156,60.4,4032,58.6,124,1.8,130,1.9,106,1.5,24,0.3,2599,37.7
E02005424,8745,100,4457,51,4323,49.4,134,1.5,134,1.5,98,1.1,36,0.4,4154,47.5
E02005425,5575,100,2817,50.5,2720,48.8,97,1.7,47,0.8,38,0.7,9,0.2,2711,48.6
E02005426,8436,100,4442,52.7,4217,50,225,2.7,92,1.1,68,0.8,24,0.3,3902,46.3
E02005427,5870,100,3115,53.1,2956,50.4,159,2.7,59,1,52,0.9,7,0.1,2696,45.9
E02005428,7339,100,2746,37.4,2477,33.8,269,3.7,63,0.9,47,0.6,16,0.2,4530,61.7
E02005429,5755,100,1604,27.9,1459,25.4,145,2.5,38,0.7,30,0.5,8,0.1,4113,71.5
E02005430,6139,100,3075,50.1,2955,48.1,120,2,83,1.4,59,1,24,0.4,2981,48.6
E02005431,7607,100,3496,46,3317,43.6,179,2.4,65,0.9,47,0.6,18,0.2,4046,53.2
E02005432,6747,100,3489,51.7,3353,49.7,136,2,88,1.3,73,1.1,15,0.2,3170,47
E02005433,6310,100,2274,36,2037,32.3,237,3.8,47,0.7,37,0.6,10,0.2,3989,63.2
E02005434,6310,100,3311,52.5,3186,50.5,125,2,101,1.6,87,1.4,14,0.2,2898,45.9
E02005435,6680,100,3115,46.6,2863,42.9,252,3.8,67,1,52,0.8,15,0.2,3498,52.4
E02005436,6896,100,3329,48.3,3171,46,158,2.3,64,0.9,52,0.8,12,0.2,3503,50.8
E02005437,5238,100,2708,51.7,2417,46.1,291,5.6,43,0.8,31,0.6,12,0.2,2487,47.5
E02005438,5732,100,2541,44.3,2314,40.4,227,4,48,0.8,40,0.7,8,0.1,3143,54.8
E02005439,10019,100,5394,53.8,5216,52.1,178,1.8,105,1,88,0.9,17,0.2,4520,45.1
E02005440,4713,100,2175,46.1,2013,42.7,162,3.4,53,1.1,43,0.9,10,0.2,2485,52.7
E02005441,7305,100,3724,51,3581,49,143,2,74,1,58,0.8,16,0.2,3507,48
E02005442,5140,100,2867,55.8,2680,52.1,187,3.6,101,2,68,1.3,33,0.6,2172,42.3
E02005443,6098,100,3643,59.7,3455,56.7,188,3.1,118,1.9,85,1.4,33,0.5,2337,38.3
E02005444,11810,100,6236,52.8,5975,50.6,261,2.2,700,5.9,504,4.3,196,1.7,4874,41.3
E02005445,10163,100,5903,58.1,5488,54,415,4.1,408,4,258,2.5,150,1.5,3852,37.9
E02005446,9953,100,2648,26.6,2508,25.2,140,1.4,1606,16.1,1019,10.2,587,5.9,5699,57.3
E02005447,7232,100,4085,56.5,3854,53.3,231,3.2,582,8,412,5.7,170,2.4,2565,35.5
E02005448,5708,100,3350,58.7,3184,55.8,166,2.9,117,2,86,1.5,31,0.5,2241,39.3
E02005449,8195,100,3868,47.2,3688,45,180,2.2,667,8.1,401,4.9,266,3.2,3660,44.7
E02005450,7136,100,4110,57.6,4005,56.1,105,1.5,111,1.6,81,1.1,30,0.4,2915,40.8
E02005451,6272,100,3667,58.5,3441,54.9,226,3.6,135,2.2,107,1.7,28,0.4,2470,39.4
E02005452,9355,100,5479,58.6,5279,56.4,200,2.1,193,2.1,141,1.5,52,0.6,3683,39.4
E02005453,9118,100,5117,56.1,4990,54.7,127,1.4,154,1.7,115,1.3,39,0.4,3847,42.2
E02005455,11790,100,7436,63.1,7266,61.6,170,1.4,198,1.7,143,1.2,55,0.5,4156,35.3
E02005456,8885,100,5537,62.3,5384,60.6,153,1.7,133,1.5,109,1.2,24,0.3,3215,36.2
E02005457,7215,100,4123,57.1,4004,55.5,119,1.6,109,1.5,91,1.3,18,0.2,2983,41.3
E02005458,5768,100,3098,53.7,3029,52.5,69,1.2,66,1.1,49,0.8,17,0.3,2604,45.1
E02005459,7057,100,3768,53.4,3607,51.1,161,2.3,105,1.5,82,1.2,23,0.3,3184,45.1
E02005460,5306,100,3502,66,3406,64.2,96,1.8,88,1.7,81,1.5,7,0.1,1716,32.3
E02005461,5574,100,2841,51,2757,49.5,84,1.5,65,1.2,41,0.7,24,0.4,2668,47.9
E02005462,7972,100,4667,58.5,4456,55.9,211,2.6,123,1.5,101,1.3,22,0.3,3182,39.9
E02005463,8032,100,5156,64.2,5016,62.5,140,1.7,158,2,131,1.6,27,0.3,2718,33.8
E02005464,7423,100,3835,51.7,3685,49.6,150,2,91,1.2,70,0.9,21,0.3,3497,47.1
E02006866,7037,100,4461,63.4,4319,61.4,142,2,158,2.2,109,1.5,49,0.7,2418,34.4
E02006867,6843,100,3872,56.6,3766,55,106,1.5,118,1.7,89,1.3,29,0.4,2853,41.7
E02005465,7372,100,4020,54.5,3865,52.4,155,2.1,86,1.2,71,1,15,0.2,3266,44.3
E02005466,5727,100,3060,53.4,2922,51,138,2.4,51,0.9,36,0.6,15,0.3,2616,45.7
E02005467,6422,100,3632,56.6,3490,54.3,142,2.2,70,1.1,57,0.9,13,0.2,2720,42.4
E02005468,6411,100,3509,54.7,3379,52.7,130,2,91,1.4,70,1.1,21,0.3,2811,43.8
E02005469,6542,100,3993,61,3838,58.7,155,2.4,72,1.1,51,0.8,21,0.3,2477,37.9
E02005470,10570,100,7050,66.7,6840,64.7,210,2,181,1.7,146,1.4,35,0.3,3339,31.6
E02005471,7536,100,4556,60.5,4361,57.9,195,2.6,127,1.7,107,1.4,20,0.3,2853,37.9
E02005472,8335,100,4348,52.2,4133,49.6,215,2.6,94,1.1,65,0.8,29,0.3,3893,46.7
E02005473,8063,100,5093,63.2,4922,61,171,2.1,88,1.1,75,0.9,13,0.2,2882,35.7
E02005474,6128,100,3318,54.1,3188,52,130,2.1,62,1,46,0.8,16,0.3,2748,44.8
E02005475,5886,100,3630,61.7,3513,59.7,117,2,71,1.2,53,0.9,18,0.3,2185,37.1
E02005476,6065,100,3467,57.2,3360,55.4,107,1.8,85,1.4,70,1.2,15,0.2,2513,41.4
E02005477,7709,100,3953,51.3,3840,49.8,113,1.5,102,1.3,67,0.9,35,0.5,3654,47.4
E02005478,8127,100,4422,54.4,4183,51.5,239,2.9,118,1.5,96,1.2,22,0.3,3587,44.1
E02005479,8150,100,5075,62.3,4870,59.8,205,2.5,105,1.3,72,0.9,33,0.4,2970,36.4
E02005480,5561,100,3336,60,3112,56,224,4,105,1.9,76,1.4,29,0.5,2120,38.1
E02005481,9957,100,6510,65.4,6164,61.9,346,3.5,166,1.7,131,1.3,35,0.4,3281,33
E02005482,8071,100,4846,60,4710,58.4,136,1.7,112,1.4,76,0.9,36,0.4,3113,38.6
E02005483,6663,100,3788,56.9,3660,54.9,128,1.9,92,1.4,73,1.1,19,0.3,2783,41.8
E02005484,6002,100,3504,58.4,3401,56.7,103,1.7,63,1,51,0.8,12,0.2,2435,40.6
E02005485,6750,100,4194,62.1,4082,60.5,112,1.7,87,1.3,72,1.1,15,0.2,2469,36.6
E02005486,7707,100,4627,60,4481,58.1,146,1.9,111,1.4,78,1,33,0.4,2969,38.5
E02005487,8249,100,4622,56,4468,54.2,154,1.9,107,1.3,87,1.1,20,0.2,3520,42.7
E02005488,5871,100,3263,55.6,3169,54,94,1.6,91,1.5,71,1.2,20,0.3,2517,42.9
E02005489,6020,100,3671,61,3546,58.9,125,2.1,97,1.6,80,1.3,17,0.3,2252,37.4
E02005490,7580,100,4582,60.4,4390,57.9,192,2.5,90,1.2,72,0.9,18,0.2,2908,38.4
E02005491,9533,100,5653,59.3,5480,57.5,173,1.8,145,1.5,112,1.2,33,0.3,3735,39.2
E02005492,8279,100,4410,53.3,4292,51.8,118,1.4,89,1.1,62,0.7,27,0.3,3780,45.7
E02005493,8457,100,4768,56.4,4604,54.4,164,1.9,144,1.7,110,1.3,34,0.4,3545,41.9
E02005494,8243,100,4256,51.6,4074,49.4,182,2.2,108,1.3,76,0.9,32,0.4,3879,47.1
E02005495,8516,100,4648,54.6,4232,49.7,416,4.9,107,1.3,79,0.9,28,0.3,3761,44.2
E02005496,5348,100,3006,56.2,2908,54.4,98,1.8,73,1.4,55,1,18,0.3,2269,42.4
E02005497,5690,100,3007,52.8,2755,48.4,252,4.4,78,1.4,54,0.9,24,0.4,2605,45.8
E02005498,6452,100,3196,49.5,3090,47.9,106,1.6,54,0.8,48,0.7,6,0.1,3202,49.6
E02005499,7003,100,4010,57.3,3891,55.6,119,1.7,108,1.5,85,1.2,23,0.3,2885,41.2
E02005500,6216,100,3611,58.1,3507,56.4,104,1.7,93,1.5,65,1,28,0.5,2512,40.4
E02005501,6769,100,3692,54.5,3613,53.4,79,1.2,105,1.6,88,1.3,17,0.3,2972,43.9
E02005502,8144,100,4471,54.9,4358,53.5,113,1.4,121,1.5,87,1.1,34,0.4,3552,43.6
E02005819,5211,100,2763,53,2626,50.4,137,2.6,58,1.1,40,0.8,18,0.3,2390,45.9
E02005820,4710,100,2627,55.8,2541,53.9,86,1.8,72,1.5,58,1.2,14,0.3,2011,42.7
E02005821,5373,100,3095,57.6,2932,54.6,163,3,85,1.6,67,1.2,18,0.3,2193,40.8
E02005822,8115,100,5040,62.1,4770,58.8,270,3.3,140,1.7,106,1.3,34,0.4,2935,36.2
E02005823,6157,100,3139,51,2918,47.4,221,3.6,81,1.3,61,1,20,0.3,2937,47.7
E02005824,8136,100,4891,60.1,4690,57.6,201,2.5,132,1.6,106,1.3,26,0.3,3113,38.3
E02005825,6267,100,3427,54.7,3270,52.2,157,2.5,92,1.5,70,1.1,22,0.4,2748,43.8
E02005826,4774,100,2684,56.2,2502,52.4,182,3.8,78,1.6,47,1,31,0.6,2012,42.1
E02005827,7718,100,4847,62.8,4724,61.2,123,1.6,126,1.6,88,1.1,38,0.5,2745,35.6
E02005828,6382,100,3687,57.8,3560,55.8,127,2,75,1.2,58,0.9,17,0.3,2620,41.1
E02005829,5476,100,3059,55.9,2936,53.6,123,2.2,59,1.1,39,0.7,20,0.4,2358,43.1
E02005830,5052,100,2833,56.1,2720,53.8,113,2.2,50,1,34,0.7,16,0.3,2169,42.9
E02005831,8514,100,5398,63.4,5210,61.2,188,2.2,135,1.6,106,1.2,29,0.3,2981,35
E02005832,7602,100,4657,61.3,4410,58,247,3.2,126,1.7,102,1.3,24,0.3,2819,37.1
E02005833,6342,100,3729,58.8,3582,56.5,147,2.3,100,1.6,79,1.2,21,0.3,2513,39.6
E02005834,7026,100,4153,59.1,3903,55.6,250,3.6,107,1.5,83,1.2,24,0.3,2766,39.4
E02005835,9115,100,5288,58,5073,55.7,215,2.4,104,1.1,71,0.8,33,0.4,3723,40.8
E02005836,7765,100,4347,56,4229,54.5,118,1.5,90,1.2,67,0.9,23,0.3,3328,42.9
E02005837,6769,100,3381,49.9,3239,47.9,142,2.1,47,0.7,39,0.6,8,0.1,3341,49.4
E02005838,6804,100,3683,54.1,3551,52.2,132,1.9,85,1.2,61,0.9,24,0.4,3036,44.6
E02005839,5391,100,2883,53.5,2770,51.4,113,2.1,77,1.4,51,0.9,26,0.5,2431,45.1
E02005840,7737,100,5213,67.4,5073,65.6,140,1.8,189,2.4,162,2.1,27,0.3,2335,30.2
E02005842,7273,100,3936,54.1,3756,51.6,180,2.5,97,1.3,73,1,24,0.3,3240,44.5
E02005843,5683,100,3630,63.9,3506,61.7,124,2.2,106,1.9,95,1.7,11,0.2,1947,34.3
E02005844,7064,100,4336,61.4,4151,58.8,185,2.6,116,1.6,96,1.4,20,0.3,2612,37
E02005846,5317,100,3136,59,2933,55.2,203,3.8,87,1.6,73,1.4,14,0.3,2094,39.4
E02005847,5839,100,3428,58.7,3304,56.6,124,2.1,76,1.3,61,1,15,0.3,2335,40
E02005848,5389,100,2976,55.2,2894,53.7,82,1.5,93,1.7,69,1.3,24,0.4,2320,43.1
E02005849,7941,100,4417,55.6,4285,54,132,1.7,145,1.8,114,1.4,31,0.4,3379,42.6
E02006903,9265,100,5153,55.6,5004,54,149,1.6,147,1.6,109,1.2,38,0.4,3965,42.8
E02005850,5618,100,3132,55.7,3029,53.9,103,1.8,61,1.1,47,0.8,14,0.2,2425,43.2
E02005851,4993,100,2702,54.1,2537,50.8,165,3.3,63,1.3,45,0.9,18,0.4,2228,44.6
E02005852,7020,100,3895,55.5,3794,54,101,1.4,101,1.4,83,1.2,18,0.3,3024,43.1
E02005853,7603,100,4431,58.3,4270,56.2,161,2.1,115,1.5,82,1.1,33,0.4,3057,40.2
E02005856,6103,100,3247,53.2,3162,51.8,85,1.4,83,1.4,66,1.1,17,0.3,2773,45.4
E02005857,4957,100,2974,60,2843,57.4,131,2.6,60,1.2,36,0.7,24,0.5,1923,38.8
E02005858,6848,100,3444,50.3,3281,47.9,163,2.4,291,4.2,209,3.1,82,1.2,3113,45.5
E02005859,7530,100,4607,61.2,4380,58.2,227,3,108,1.4,82,1.1,26,0.3,2815,37.4
E02005860,8056,100,4022,49.9,3819,47.4,203,2.5,462,5.7,319,4,143,1.8,3572,44.3
E02005861,4556,100,2881,63.2,2783,61.1,98,2.2,84,1.8,71,1.6,13,0.3,1591,34.9
E02005862,6165,100,3458,56.1,3284,53.3,174,2.8,115,1.9,96,1.6,19,0.3,2592,42
E02005863,6225,100,3500,56.2,3384,54.4,116,1.9,91,1.5,70,1.1,21,0.3,2634,42.3
E02005864,6632,100,4165,62.8,4059,61.2,106,1.6,120,1.8,98,1.5,22,0.3,2347,35.4
E02006906,10230,100,6024,58.9,5848,57.2,176,1.7,177,1.7,137,1.3,40,0.4,4029,39.4
E02005865,7197,100,3987,55.4,3889,54,98,1.4,106,1.5,73,1,33,0.5,3104,43.1
E02005866,7619,100,4340,57,4213,55.3,127,1.7,87,1.1,60,0.8,27,0.4,3192,41.9
E02005868,5957,100,3518,59.1,3391,56.9,127,2.1,92,1.5,66,1.1,26,0.4,2347,39.4
E02005869,4621,100,2683,58.1,2529,54.7,154,3.3,88,1.9,60,1.3,28,0.6,1850,40
E02005870,5381,100,3294,61.2,3116,57.9,178,3.3,77,1.4,57,1.1,20,0.4,2010,37.4
E02005871,5968,100,3404,57,3272,54.8,132,2.2,64,1.1,44,0.7,20,0.3,2500,41.9
E02005872,5462,100,3103,56.8,3025,55.4,78,1.4,87,1.6,75,1.4,12,0.2,2272,41.6
E02005873,8332,100,4773,57.3,4639,55.7,134,1.6,119,1.4,95,1.1,24,0.3,3440,41.3
E02005874,7029,100,4329,61.6,4194,59.7,135,1.9,97,1.4,80,1.1,17,0.2,2603,37
E02005875,6610,100,4212,63.7,4061,61.4,151,2.3,88,1.3,72,1.1,16,0.2,2310,34.9
E02005876,7222,100,4368,60.5,4190,58,178,2.5,108,1.5,92,1.3,16,0.2,2746,38
E02005877,6002,100,3705,61.7,3565,59.4,140,2.3,92,1.5,75,1.2,17,0.3,2205,36.7
E02005878,8113,100,4700,57.9,4485,55.3,215,2.7,139,1.7,98,1.2,41,0.5,3274,40.4
E02005879,5931,100,3846,64.8,3668,61.8,178,3,106,1.8,83,1.4,23,0.4,1979,33.4
E02006835,5015,100,3000,59.8,2871,57.2,129,2.6,87,1.7,63,1.3,24,0.5,1928,38.4
E02005880,5095,100,2744,53.9,2619,51.4,125,2.5,44,0.9,32,0.6,12,0.2,2307,45.3
E02005881,5067,100,2875,56.7,2745,54.2,130,2.6,71,1.4,47,0.9,24,0.5,2121,41.9
E02005882,6535,100,3578,54.8,3509,53.7,69,1.1,115,1.8,87,1.3,28,0.4,2842,43.5
E02005883,6620,100,3887,58.7,3692,55.8,195,2.9,104,1.6,75,1.1,29,0.4,2629,39.7
E02005884,5160,100,2984,57.8,2870,55.6,114,2.2,77,1.5,65,1.3,12,0.2,2099,40.7
E02005885,7304,100,4081,55.9,3904,53.5,177,2.4,111,1.5,92,1.3,19,0.3,3112,42.6
E02005886,9262,100,5569,60.1,5375,58,194,2.1,180,1.9,140,1.5,40,0.4,3513,37.9
E02005887,8357,100,5143,61.5,4863,58.2,280,3.4,159,1.9,130,1.6,29,0.3,3055,36.6
E02005888,6805,100,3977,58.4,3716,54.6,261,3.8,115,1.7,91,1.3,24,0.4,2713,39.9
E02005889,8658,100,4905,56.7,4684,54.1,221,2.6,141,1.6,118,1.4,23,0.3,3612,41.7
E02005890,5544,100,3338,60.2,3263,58.9,75,1.4,72,1.3,58,1,14,0.3,2134,38.5
E02005891,5049,100,2639,52.3,2437,48.3,202,4,53,1,39,0.8,14,0.3,2357,46.7
E02005892,10719,100,6722,62.7,6564,61.2,158,1.5,200,1.9,154,1.4,46,0.4,3797,35.4
E02005893,9222,100,5337,57.9,5117,55.5,220,2.4,145,1.6,111,1.2,34,0.4,3740,40.6
E02005894,9449,100,5659,59.9,5464,57.8,195,2.1,150,1.6,123,1.3,27,0.3,3640,38.5
E02005895,6906,100,3740,54.2,3657,53,83,1.2,81,1.2,62,0.9,19,0.3,3085,44.7
E02005896,6507,100,3400,52.3,3292,50.6,108,1.7,88,1.4,64,1,24,0.4,3019,46.4
E02005897,7712,100,4374,56.7,4255,55.2,119,1.5,106,1.4,84,1.1,22,0.3,3232,41.9
E02005898,9298,100,5456,58.7,5277,56.8,179,1.9,123,1.3,94,1,29,0.3,3719,40
E02005899,9670,100,6095,63,5808,60.1,287,3,131,1.4,105,1.1,26,0.3,3444,35.6
E02005900,6491,100,2991,46.1,2887,44.5,104,1.6,192,3,139,2.1,53,0.8,3308,51
E02005901,7835,100,4840,61.8,4631,59.1,209,2.7,121,1.5,102,1.3,19,0.2,2874,36.7
E02005902,6630,100,3494,52.7,3335,50.3,159,2.4,80,1.2,69,1,11,0.2,3056,46.1
E02005903,8631,100,5008,58,4857,56.3,151,1.7,130,1.5,101,1.2,29,0.3,3493,40.5
E02005904,7736,100,4618,59.7,4501,58.2,117,1.5,131,1.7,104,1.3,27,0.3,2987,38.6
E02005905,5881,100,3000,51,2817,47.9,183,3.1,72,1.2,59,1,13,0.2,2809,47.8
E02005906,6251,100,3218,51.5,3122,49.9,96,1.5,93,1.5,70,1.1,23,0.4,2940,47
E02005907,8067,100,4868,60.3,4720,58.5,148,1.8,131,1.6,100,1.2,31,0.4,3068,38
E02005908,7716,100,4278,55.4,4152,53.8,126,1.6,118,1.5,85,1.1,33,0.4,3320,43
E02005909,6598,100,4255,64.5,4145,62.8,110,1.7,206,3.1,159,2.4,47,0.7,2137,32.4
E02005910,7468,100,4475,59.9,4294,57.5,181,2.4,390,5.2,302,4,88,1.2,2603,34.9
E02005911,6873,100,4351,63.3,4213,61.3,138,2,121,1.8,104,1.5,17,0.2,2401,34.9
E02005912,7649,100,4520,59.1,4368,57.1,152,2,101,1.3,80,1,21,0.3,3028,39.6
E02005913,6799,100,4063,59.8,3926,57.7,137,2,146,2.1,110,1.6,36,0.5,2590,38.1
E02005914,6591,100,4202,63.8,4055,61.5,147,2.2,102,1.5,90,1.4,12,0.2,2287,34.7
E02005915,4845,100,2748,56.7,2673,55.2,75,1.5,53,1.1,38,0.8,15,0.3,2044,42.2
E02005916,6190,100,3874,62.6,3772,60.9,102,1.6,78,1.3,66,1.1,12,0.2,2238,36.2
E02005917,5035,100,2558,50.8,2511,49.9,47,0.9,78,1.5,61,1.2,17,0.3,2399,47.6
E02005918,4296,100,2274,52.9,2200,51.2,74,1.7,60,1.4,44,1,16,0.4,1962,45.7
E02005919,6105,100,3272,53.6,3174,52,98,1.6,160,2.6,121,2,39,0.6,2673,43.8
E02005920,7234,100,4241,58.6,4160,57.5,81,1.1,83,1.1,63,0.9,20,0.3,2910,40.2
E02002905,5420,100,2970,54.8,2893,53.4,77,1.4,58,1.1,43,0.8,15,0.3,2392,44.1
E02002906,4618,100,2534,54.9,2425,52.5,109,2.4,65,1.4,53,1.1,12,0.3,2019,43.7
E02002907,5256,100,2920,55.6,2787,53,133,2.5,61,1.2,50,1,11,0.2,2275,43.3
E02002908,7593,100,4145,54.6,4020,52.9,125,1.6,80,1.1,67,0.9,13,0.2,3368,44.4
E02002909,9217,100,5014,54.4,4836,52.5,178,1.9,94,1,73,0.8,21,0.2,4109,44.6
E02002910,6757,100,3648,54,3529,52.2,119,1.8,65,1,47,0.7,18,0.3,3044,45
E02002911,8039,100,4454,55.4,4316,53.7,138,1.7,129,1.6,99,1.2,30,0.4,3456,43
E02002912,6320,100,3826,60.5,3714,58.8,112,1.8,102,1.6,77,1.2,25,0.4,2392,37.8
E02002913,5052,100,2558,50.6,2481,49.1,77,1.5,50,1,38,0.8,12,0.2,2444,48.4
E02002914,7444,100,4504,60.5,4360,58.6,144,1.9,130,1.7,108,1.5,22,0.3,2810,37.7
E02002915,6663,100,3973,59.6,3858,57.9,115,1.7,126,1.9,102,1.5,24,0.4,2564,38.5
E02002916,8198,100,5191,63.3,4933,60.2,258,3.1,128,1.6,103,1.3,25,0.3,2879,35.1
E02002917,5777,100,3683,63.8,3548,61.4,135,2.3,105,1.8,83,1.4,22,0.4,1989,34.4
E02002918,4790,100,2685,56.1,2608,54.4,77,1.6,105,2.2,85,1.8,20,0.4,2000,41.8
E02002919,7216,100,4476,62,4265,59.1,211,2.9,134,1.9,107,1.5,27,0.4,2606,36.1
E02002920,5455,100,3361,61.6,3260,59.8,101,1.9,68,1.2,54,1,14,0.3,2026,37.1
E02002921,5998,100,3661,61,3471,57.9,190,3.2,141,2.4,119,2,22,0.4,2196,36.6
E02002922,5626,100,3168,56.3,3075,54.7,93,1.7,70,1.2,54,1,16,0.3,2388,42.4
E02002923,8086,100,4338,53.6,4167,51.5,171,2.1,104,1.3,86,1.1,18,0.2,3644,45.1
E02002924,5090,100,2864,56.3,2779,54.6,85,1.7,61,1.2,46,0.9,15,0.3,2165,42.5
E02002925,9035,100,5354,59.3,5195,57.5,159,1.8,122,1.4,92,1,30,0.3,3559,39.4
E02002926,9285,100,5077,54.7,4842,52.1,235,2.5,100,1.1,78,0.8,22,0.2,4108,44.2
E02002927,10192,100,5565,54.6,5411,53.1,154,1.5,98,1,81,0.8,17,0.2,4529,44.4
E02002928,5080,100,2594,51.1,2515,49.5,79,1.6,149,2.9,120,2.4,29,0.6,2337,46
E02002929,5731,100,2746,47.9,2681,46.8,65,1.1,177,3.1,132,2.3,45,0.8,2808,49
E02002930,5729,100,3116,54.4,3014,52.6,102,1.8,176,3.1,143,2.5,33,0.6,2437,42.5
E02002931,5468,100,3311,60.6,3242,59.3,69,1.3,80,1.5,56,1,24,0.4,2077,38
E02002932,6965,100,4147,59.5,3922,56.3,225,3.2,128,1.8,94,1.3,34,0.5,2690,38.6
E02002933,6714,100,3899,58.1,3744,55.8,155,2.3,125,1.9,96,1.4,29,0.4,2690,40.1
E02002934,5063,100,2963,58.5,2841,56.1,122,2.4,96,1.9,77,1.5,19,0.4,2004,39.6
E02002935,5560,100,3167,57,2991,53.8,176,3.2,77,1.4,50,0.9,27,0.5,2316,41.7
E02002936,8476,100,5595,66,5313,62.7,282,3.3,215,2.5,173,2,42,0.5,2666,31.5
E02002937,9141,100,5486,60,5322,58.2,164,1.8,114,1.2,86,0.9,28,0.3,3541,38.7
E02002938,5754,100,3173,55.1,2968,51.6,205,3.6,104,1.8,76,1.3,28,0.5,2477,43
E02002939,6305,100,3510,55.7,3342,53,168,2.7,99,1.6,79,1.3,20,0.3,2696,42.8
E02002940,4894,100,2946,60.2,2812,57.5,134,2.7,68,1.4,48,1,20,0.4,1880,38.4
E02002941,8576,100,5009,58.4,4777,55.7,232,2.7,139,1.6,96,1.1,43,0.5,3428,40
E02002942,6294,100,4065,64.6,3942,62.6,123,2,143,2.3,90,1.4,53,0.8,2086,33.1
E02002944,6499,100,3717,57.2,3487,53.7,230,3.5,121,1.9,86,1.3,35,0.5,2661,40.9
E02002945,7483,100,4520,60.4,4283,57.2,237,3.2,131,1.8,92,1.2,39,0.5,2832,37.8
E02002946,6285,100,3709,59,3552,56.5,157,2.5,83,1.3,57,0.9,26,0.4,2493,39.7
E02002947,5385,100,2985,55.4,2725,50.6,260,4.8,97,1.8,67,1.2,30,0.6,2303,42.8
E02002948,5469,100,2980,54.5,2691,49.2,289,5.3,118,2.2,81,1.5,37,0.7,2371,43.4
E02002949,4564,100,2515,55.1,2382,52.2,133,2.9,48,1.1,29,0.6,19,0.4,2001,43.8
E02002950,4494,100,2296,51.1,2098,46.7,198,4.4,69,1.5,47,1,22,0.5,2129,47.4
E02007050,6317,100,4494,71.1,4316,68.3,178,2.8,134,2.1,86,1.4,48,0.8,1689,26.7
E02007051,6430,100,4628,72,4488,69.8,140,2.2,124,1.9,96,1.5,28,0.4,1678,26.1
E02002951,6425,100,3605,56.1,3455,53.8,150,2.3,131,2,93,1.4,38,0.6,2689,41.9
E02002952,5851,100,3554,60.7,3418,58.4,136,2.3,113,1.9,89,1.5,24,0.4,2184,37.3
E02002953,5878,100,3025,51.5,2884,49.1,141,2.4,115,2,74,1.3,41,0.7,2738,46.6
E02002954,6577,100,3678,55.9,3465,52.7,213,3.2,108,1.6,72,1.1,36,0.5,2791,42.4
E02002955,5572,100,3031,54.4,2814,50.5,217,3.9,108,1.9,69,1.2,39,0.7,2433,43.7
E02002956,7257,100,4013,55.3,3793,52.3,220,3,172,2.4,126,1.7,46,0.6,3072,42.3
E02002957,8007,100,4620,57.7,4503,56.2,117,1.5,159,2,113,1.4,46,0.6,3228,40.3
E02002958,6710,100,3986,59.4,3823,57,163,2.4,136,2,103,1.5,33,0.5,2588,38.6
E02002959,7002,100,3822,54.6,3522,50.3,300,4.3,138,2,96,1.4,42,0.6,3042,43.4
E02002960,4767,100,2818,59.1,2706,56.8,112,2.3,82,1.7,68,1.4,14,0.3,1867,39.2
E02002961,5624,100,3143,55.9,2933,52.2,210,3.7,134,2.4,99,1.8,35,0.6,2347,41.7
E02002962,5984,100,3149,52.6,2929,48.9,220,3.7,100,1.7,68,1.1,32,0.5,2735,45.7
E02002963,5775,100,3439,59.5,3160,54.7,279,4.8,89,1.5,69,1.2,20,0.3,2247,38.9
E02002964,7108,100,3795,53.4,3621,50.9,174,2.4,119,1.7,94,1.3,25,0.4,3194,44.9
E02002965,6401,100,3127,48.9,2806,43.8,321,5,316,4.9,206,3.2,110,1.7,2958,46.2
E02002966,8571,100,4016,46.9,3758,43.8,258,3,774,9,538,6.3,236,2.8,3781,44.1
E02002967,7652,100,4124,53.9,3796,49.6,328,4.3,161,2.1,107,1.4,54,0.7,3367,44
E02002968,7892,100,4811,61,4614,58.5,197,2.5,288,3.6,214,2.7,74,0.9,2793,35.4
E02002969,7760,100,4492,57.9,4209,54.2,283,3.6,322,4.1,245,3.2,77,1,2946,38
E02002970,6360,100,3641,57.2,3449,54.2,192,3,168,2.6,120,1.9,48,0.8,2551,40.1
E02002973,6451,100,3839,59.5,3655,56.7,184,2.9,155,2.4,114,1.8,41,0.6,2457,38.1
E02002974,5037,100,2766,54.9,2670,53,96,1.9,86,1.7,71,1.4,15,0.3,2185,43.4
E02002975,6029,100,3812,63.2,3727,61.8,85,1.4,126,2.1,94,1.6,32,0.5,2091,34.7
E02002976,4719,100,2726,57.8,2594,55,132,2.8,93,2,73,1.5,20,0.4,1900,40.3
E02002977,4707,100,2293,48.7,2182,46.4,111,2.4,81,1.7,61,1.3,20,0.4,2333,49.6
E02002978,5158,100,2836,55,2637,51.1,199,3.9,79,1.5,53,1,26,0.5,2243,43.5
E02002979,4506,100,2306,51.2,2118,47,188,4.2,115,2.6,89,2,26,0.6,2085,46.3
E02002980,5034,100,2605,51.7,2529,50.2,76,1.5,101,2,77,1.5,24,0.5,2328,46.2
E02002981,6485,100,3694,57,3520,54.3,174,2.7,144,2.2,116,1.8,28,0.4,2647,40.8
E02002982,6637,100,3893,58.7,3721,56.1,172,2.6,136,2,93,1.4,43,0.6,2608,39.3
E02002983,4424,100,2567,58,2515,56.8,52,1.2,89,2,59,1.3,30,0.7,1768,40
E02002984,4649,100,2589,55.7,2549,54.8,40,0.9,98,2.1,84,1.8,14,0.3,1962,42.2
E02006974,8887,100,4970,55.9,4749,53.4,221,2.5,155,1.7,119,1.3,36,0.4,3762,42.3
E02006008,8568,100,5491,64.1,5278,61.6,213,2.5,98,1.1,73,0.9,25,0.3,2979,34.8
E02006009,6961,100,4112,59.1,3987,57.3,125,1.8,252,3.6,225,3.2,27,0.4,2597,37.3
E02006010,9948,100,5520,55.5,5323,53.5,197,2,110,1.1,79,0.8,31,0.3,4318,43.4
E02006011,4829,100,2514,52.1,2401,49.7,113,2.3,57,1.2,45,0.9,12,0.2,2258,46.8
E02006012,5385,100,2900,53.9,2777,51.6,123,2.3,57,1.1,42,0.8,15,0.3,2428,45.1
E02006013,6790,100,3797,55.9,3655,53.8,142,2.1,87,1.3,64,0.9,23,0.3,2906,42.8
E02006014,8484,100,4584,54,4431,52.2,153,1.8,97,1.1,81,1,16,0.2,3803,44.8
E02006015,8472,100,4871,57.5,4668,55.1,203,2.4,132,1.6,108,1.3,24,0.3,3469,40.9
E02006016,6963,100,3909,56.1,3784,54.3,125,1.8,92,1.3,79,1.1,13,0.2,2962,42.5
E02006017,6804,100,3706,54.5,3572,52.5,134,2,80,1.2,52,0.8,28,0.4,3018,44.4
E02006018,10284,100,5831,56.7,5601,54.5,230,2.2,113,1.1,89,0.9,24,0.2,4340,42.2
E02006019,5347,100,2856,53.4,2734,51.1,122,2.3,95,1.8,89,1.7,6,0.1,2396,44.8
E02006020,6583,100,3705,56.3,3587,54.5,118,1.8,67,1,50,0.8,17,0.3,2811,42.7
E02006021,7303,100,4403,60.3,4270,58.5,133,1.8,108,1.5,91,1.2,17,0.2,2792,38.2
E02006022,5049,100,3072,60.8,2976,58.9,96,1.9,84,1.7,74,1.5,10,0.2,1893,37.5
E02006023,8306,100,4625,55.7,4476,53.9,149,1.8,137,1.6,111,1.3,26,0.3,3544,42.7
E02006024,8106,100,4876,60.2,4672,57.6,204,2.5,122,1.5,99,1.2,23,0.3,3108,38.3
E02006025,8172,100,4706,57.6,4477,54.8,229,2.8,125,1.5,108,1.3,17,0.2,3341,40.9
E02006026,6154,100,3472,56.4,3384,55,88,1.4,91,1.5,73,1.2,18,0.3,2591,42.1
E02006027,4655,100,2625,56.4,2543,54.6,82,1.8,68,1.5,54,1.2,14,0.3,1962,42.1
E02006028,8275,100,4830,58.4,4718,57,112,1.4,104,1.3,83,1,21,0.3,3341,40.4
E02006029,6410,100,3825,59.7,3632,56.7,193,3,83,1.3,68,1.1,15,0.2,2502,39
E02006030,7386,100,4655,63,4296,58.2,359,4.9,118,1.6,107,1.4,11,0.1,2613,35.4
E02006031,6776,100,4274,63.1,4122,60.8,152,2.2,99,1.5,88,1.3,11,0.2,2403,35.5
E02006032,6966,100,4117,59.1,3920,56.3,197,2.8,129,1.9,111,1.6,18,0.3,2720,39
E02006033,7466,100,4415,59.1,4245,56.9,170,2.3,124,1.7,93,1.2,31,0.4,2927,39.2
E02006034,8688,100,5285,60.8,5125,59,160,1.8,184,2.1,139,1.6,45,0.5,3219,37.1
E02006035,5026,100,2543,50.6,2396,47.7,147,2.9,49,1,37,0.7,12,0.2,2434,48.4
E02006036,5655,100,3402,60.2,3264,57.7,138,2.4,87,1.5,74,1.3,13,0.2,2166,38.3
E02006037,8137,100,4565,56.1,4383,53.9,182,2.2,143,1.8,106,1.3,37,0.5,3429,42.1
E02006038,6959,100,4066,58.4,3928,56.4,138,2,114,1.6,100,1.4,14,0.2,2779,39.9
E02006039,6871,100,3784,55.1,3671,53.4,113,1.6,105,1.5,82,1.2,23,0.3,2982,43.4
E02006040,6603,100,3831,58,3752,56.8,79,1.2,91,1.4,77,1.2,14,0.2,2681,40.6
E02006041,4887,100,2710,55.5,2630,53.8,80,1.6,52,1.1,38,0.8,14,0.3,2125,43.5
E02006042,5125,100,2277,44.4,2202,43,75,1.5,56,1.1,40,0.8,16,0.3,2792,54.5
E02006043,5708,100,3245,56.9,3140,55,105,1.8,55,1,41,0.7,14,0.2,2408,42.2
E02006044,5361,100,2791,52.1,2738,51.1,53,1,57,1.1,45,0.8,12,0.2,2513,46.9
E02006045,9187,100,4632,50.4,4439,48.3,193,2.1,113,1.2,90,1,23,0.3,4442,48.4
E02006046,7585,100,4174,55,4059,53.5,115,1.5,65,0.9,50,0.7,15,0.2,3346,44.1
E02006118,6315,100,3586,56.8,3476,55,110,1.7,106,1.7,86,1.4,20,0.3,2623,41.5
E02006119,6671,100,3845,57.6,3644,54.6,201,3,117,1.8,98,1.5,19,0.3,2709,40.6
E02006120,7485,100,4520,60.4,4308,57.6,212,2.8,132,1.8,107,1.4,25,0.3,2833,37.8
E02006121,4842,100,3015,62.3,2879,59.5,136,2.8,61,1.3,38,0.8,23,0.5,1766,36.5
E02006122,6576,100,4296,65.3,4131,62.8,165,2.5,119,1.8,87,1.3,32,0.5,2161,32.9
E02006123,5301,100,3400,64.1,3274,61.8,126,2.4,93,1.8,64,1.2,29,0.5,1808,34.1
E02006124,5828,100,3268,56.1,3066,52.6,202,3.5,78,1.3,56,1,22,0.4,2482,42.6
E02006125,6058,100,3474,57.3,3275,54.1,199,3.3,89,1.5,59,1,30,0.5,2495,41.2
E02006126,6926,100,4393,63.4,4250,61.4,143,2.1,95,1.4,65,0.9,30,0.4,2438,35.2
E02006127,5709,100,4091,71.7,3983,69.8,108,1.9,137,2.4,98,1.7,39,0.7,1481,25.9
E02006128,7242,100,3923,54.2,3747,51.7,176,2.4,113,1.6,83,1.1,30,0.4,3206,44.3
E02006129,6753,100,4003,59.3,3771,55.8,232,3.4,104,1.5,83,1.2,21,0.3,2646,39.2
E02006130,6772,100,4214,62.2,4078,60.2,136,2,108,1.6,74,1.1,34,0.5,2450,36.2
E02006131,6533,100,3771,57.7,3665,56.1,106,1.6,107,1.6,80,1.2,27,0.4,2655,40.6
E02006132,5639,100,3569,63.3,3473,61.6,96,1.7,114,2,92,1.6,22,0.4,1956,34.7
E02006133,5820,100,3588,61.6,3482,59.8,106,1.8,152,2.6,115,2,37,0.6,2080,35.7
E02006134,8669,100,5035,58.1,4906,56.6,129,1.5,132,1.5,110,1.3,22,0.3,3502,40.4
E02006135,6529,100,3722,57,3609,55.3,113,1.7,116,1.8,88,1.3,28,0.4,2691,41.2
E02006136,7847,100,4124,52.6,3955,50.4,169,2.2,105,1.3,79,1,26,0.3,3618,46.1
E02006137,7189,100,4219,58.7,4040,56.2,179,2.5,147,2,111,1.5,36,0.5,2823,39.3
E02006138,6099,100,3920,64.3,3691,60.5,229,3.8,148,2.4,111,1.8,37,0.6,2031,33.3
E02006139,6476,100,4068,62.8,3821,59,247,3.8,107,1.7,87,1.3,20,0.3,2301,35.5
E02006140,6727,100,3858,57.4,3692,54.9,166,2.5,150,2.2,98,1.5,52,0.8,2719,40.4
E02006141,9492,100,6236,65.7,5873,61.9,363,3.8,211,2.2,174,1.8,37,0.4,3045,32.1
E02006142,4435,100,2576,58.1,2522,56.9,54,1.2,85,1.9,71,1.6,14,0.3,1774,40
E02006143,7516,100,4934,65.6,4773,63.5,161,2.1,148,2,118,1.6,30,0.4,2434,32.4
E02006144,6641,100,3801,57.2,3584,54,217,3.3,110,1.7,81,1.2,29,0.4,2730,41.1
E02006145,4900,100,2846,58.1,2764,56.4,82,1.7,80,1.6,56,1.1,24,0.5,1974,40.3
E02006146,7224,100,4423,61.2,4301,59.5,122,1.7,106,1.5,86,1.2,20,0.3,2695,37.3
E02006147,6919,100,4160,60.1,4038,58.4,122,1.8,132,1.9,110,1.6,22,0.3,2627,38
E02006148,6104,100,3440,56.4,3338,54.7,102,1.7,106,1.7,71,1.2,35,0.6,2558,41.9
E02006149,8780,100,4895,55.8,4593,52.3,302,3.4,142,1.6,113,1.3,29,0.3,3743,42.6
E02006150,9776,100,5304,54.3,5129,52.5,175,1.8,108,1.1,83,0.8,25,0.3,4364,44.6
E02006151,8075,100,4865,60.2,4703,58.2,162,2,136,1.7,106,1.3,30,0.4,3074,38.1
E02006152,8514,100,5080,59.7,4930,57.9,150,1.8,145,1.7,113,1.3,32,0.4,3289,38.6
E02006153,7523,100,4834,64.3,4675,62.1,159,2.1,106,1.4,86,1.1,20,0.3,2583,34.3
E02006154,8334,100,4451,53.4,4322,51.9,129,1.5,116,1.4,82,1,34,0.4,3767,45.2
E02006155,4499,100,2708,60.2,2558,56.9,150,3.3,76,1.7,59,1.3,17,0.4,1715,38.1
E02006156,6768,100,3722,55,3616,53.4,106,1.6,98,1.4,77,1.1,21,0.3,2948,43.6
E02006157,6093,100,3400,55.8,3227,53,173,2.8,92,1.5,59,1,33,0.5,2601,42.7
E02006158,6962,100,4188,60.2,4053,58.2,135,1.9,145,2.1,103,1.5,42,0.6,2629,37.8
E02006159,4664,100,2554,54.8,2431,52.1,123,2.6,82,1.8,62,1.3,20,0.4,2028,43.5
E02006160,7053,100,4080,57.8,3891,55.2,189,2.7,94,1.3,72,1,22,0.3,2879,40.8
E02006161,5538,100,3291,59.4,3210,58,81,1.5,104,1.9,84,1.5,20,0.4,2143,38.7
E02006162,7021,100,4112,58.6,4006,57.1,106,1.5,112,1.6,78,1.1,34,0.5,2797,39.8
E02006163,6331,100,3700,58.4,3531,55.8,169,2.7,127,2,98,1.5,29,0.5,2504,39.6
E02006164,5747,100,3267,56.8,3096,53.9,171,3,119,2.1,95,1.7,24,0.4,2361,41.1
E02006165,6204,100,3875,62.5,3727,60.1,148,2.4,135,2.2,104,1.7,31,0.5,2194,35.4
E02006166,5926,100,3614,61,3536,59.7,78,1.3,139,2.3,115,1.9,24,0.4,2173,36.7
E02006167,8007,100,4205,52.5,3992,49.9,213,2.7,300,3.7,223,2.8,77,1,3502,43.7
E02006168,7374,100,3266,44.3,3057,41.5,209,2.8,460,6.2,302,4.1,158,2.1,3648,49.5
E02006169,6519,100,2583,39.6,2481,38.1,102,1.6,544,8.3,343,5.3,201,3.1,3392,52
E02006170,4387,100,2416,55.1,2329,53.1,87,2,72,1.6,55,1.3,17,0.4,1899,43.3
E02006171,7462,100,3981,53.4,3822,51.2,159,2.1,202,2.7,136,1.8,66,0.9,3279,43.9
E02006172,7981,100,4300,53.9,4176,52.3,124,1.6,159,2,119,1.5,40,0.5,3522,44.1
E02006173,6016,100,3342,55.6,3297,54.8,45,0.7,80,1.3,64,1.1,16,0.3,2594,43.1
E02006174,9189,100,5276,57.4,5125,55.8,151,1.6,178,1.9,130,1.4,48,0.5,3735,40.6
E02006175,5529,100,3522,63.7,3373,61,149,2.7,79,1.4,58,1,21,0.4,1928,34.9
E02006176,6223,100,3349,53.8,3249,52.2,100,1.6,78,1.3,70,1.1,8,0.1,2796,44.9
E02006177,8223,100,4767,58,4588,55.8,179,2.2,106,1.3,72,0.9,34,0.4,3350,40.7
E02006178,6349,100,3596,56.6,3437,54.1,159,2.5,108,1.7,79,1.2,29,0.5,2645,41.7
E02006179,8616,100,3653,42.4,3506,40.7,147,1.7,92,1.1,67,0.8,25,0.3,4871,56.5
E02006180,5717,100,3258,57,3113,54.5,145,2.5,86,1.5,59,1,27,0.5,2373,41.5
E02006181,4609,100,2489,54,2356,51.1,133,2.9,58,1.3,51,1.1,7,0.2,2062,44.7
E02006182,5922,100,3357,56.7,3269,55.2,88,1.5,103,1.7,70,1.2,33,0.6,2462,41.6
E02006185,5960,100,3239,54.3,3080,51.7,159,2.7,75,1.3,54,0.9,21,0.4,2646,44.4
E02006186,10684,100,6062,56.7,5861,54.9,201,1.9,108,1,89,0.8,19,0.2,4514,42.3
E02006187,6139,100,3101,50.5,3010,49,91,1.5,73,1.2,63,1,10,0.2,2965,48.3
E02006982,10209,100,6027,59,5766,56.5,261,2.6,126,1.2,105,1,21,0.2,4056,39.7
E02006188,5061,100,2698,53.3,2643,52.2,55,1.1,107,2.1,87,1.7,20,0.4,2256,44.6
E02006189,6141,100,3263,53.1,3183,51.8,80,1.3,96,1.6,72,1.2,24,0.4,2782,45.3
E02006190,9122,100,5446,59.7,5233,57.4,213,2.3,154,1.7,123,1.3,31,0.3,3522,38.6
E02006191,6825,100,3967,58.1,3861,56.6,106,1.6,118,1.7,102,1.5,16,0.2,2740,40.1
E02006192,7725,100,4587,59.4,4462,57.8,125,1.6,102,1.3,83,1.1,19,0.2,3036,39.3
E02006193,6203,100,3818,61.6,3701,59.7,117,1.9,118,1.9,97,1.6,21,0.3,2267,36.5
E02006194,6695,100,4119,61.5,3948,59,171,2.6,123,1.8,97,1.4,26,0.4,2453,36.6
E02006195,7413,100,4067,54.9,3982,53.7,85,1.1,104,1.4,88,1.2,16,0.2,3242,43.7
E02006196,5918,100,3500,59.1,3342,56.5,158,2.7,174,2.9,142,2.4,32,0.5,2244,37.9
E02006197,7803,100,5171,66.3,4905,62.9,266,3.4,148,1.9,127,1.6,21,0.3,2484,31.8
E02006198,7391,100,4609,62.4,4497,60.8,112,1.5,142,1.9,114,1.5,28,0.4,2640,35.7
E02006199,7128,100,4104,57.6,3989,56,115,1.6,126,1.8,107,1.5,19,0.3,2898,40.7
E02006200,6149,100,3488,56.7,3280,53.3,208,3.4,126,2,102,1.7,24,0.4,2535,41.2
E02006201,9953,100,5435,54.6,5324,53.5,111,1.1,218,2.2,177,1.8,41,0.4,4300,43.2
E02006202,7897,100,4474,56.7,4347,55,127,1.6,107,1.4,85,1.1,22,0.3,3316,42
E02006203,6186,100,3552,57.4,3368,54.4,184,3,120,1.9,96,1.6,24,0.4,2514,40.6
E02006204,6093,100,3425,56.2,3308,54.3,117,1.9,104,1.7,65,1.1,39,0.6,2564,42.1
E02006205,6294,100,3408,54.1,3340,53.1,68,1.1,106,1.7,83,1.3,23,0.4,2780,44.2
E02006206,6360,100,3865,60.8,3687,58,178,2.8,112,1.8,70,1.1,42,0.7,2383,37.5
E02006207,5401,100,2828,52.4,2746,50.8,82,1.5,57,1.1,43,0.8,14,0.3,2516,46.6
E02006208,6681,100,3912,58.6,3755,56.2,157,2.3,94,1.4,76,1.1,18,0.3,2675,40
E02006209,8958,100,5024,56.1,4894,54.6,130,1.5,163,1.8,134,1.5,29,0.3,3771,42.1
E02006210,4451,100,2609,58.6,2560,57.5,49,1.1,60,1.3,50,1.1,10,0.2,1782,40
E02006211,5445,100,2926,53.7,2854,52.4,72,1.3,120,2.2,91,1.7,29,0.5,2399,44.1
E02006212,6608,100,3585,54.3,3507,53.1,78,1.2,114,1.7,91,1.4,23,0.3,2909,44
E02006213,5535,100,3151,56.9,3039,54.9,112,2,76,1.4,62,1.1,14,0.3,2308,41.7
E02006214,5199,100,2826,54.4,2737,52.6,89,1.7,87,1.7,71,1.4,16,0.3,2286,44
E02006215,6726,100,3691,54.9,3624,53.9,67,1,115,1.7,85,1.3,30,0.4,2920,43.4
E02006216,7100,100,4019,56.6,3919,55.2,100,1.4,165,2.3,137,1.9,28,0.4,2916,41.1
E02006217,8377,100,4889,58.4,4715,56.3,174,2.1,177,2.1,118,1.4,59,0.7,3311,39.5
E02006218,7038,100,4094,58.2,3856,54.8,238,3.4,128,1.8,105,1.5,23,0.3,2816,40
E02006219,6746,100,4150,61.5,3979,59,171,2.5,116,1.7,87,1.3,29,0.4,2480,36.8
E02006220,6104,100,3523,57.7,3364,55.1,159,2.6,116,1.9,87,1.4,29,0.5,2465,40.4
E02006221,4855,100,3157,65,3040,62.6,117,2.4,140,2.9,103,2.1,37,0.8,1558,32.1
E02006222,5551,100,3335,60.1,3175,57.2,160,2.9,104,1.9,76,1.4,28,0.5,2112,38
E02006223,5102,100,2915,57.1,2681,52.5,234,4.6,130,2.5,89,1.7,41,0.8,2057,40.3
E02006224,6101,100,3988,65.4,3867,63.4,121,2,133,2.2,99,1.6,34,0.6,1980,32.5
E02006225,6069,100,3681,60.7,3580,59,101,1.7,115,1.9,83,1.4,32,0.5,2273,37.5
E02006226,7847,100,5174,65.9,4947,63,227,2.9,159,2,106,1.4,53,0.7,2514,32
E02006468,9101,100,5557,61.1,5386,59.2,171,1.9,143,1.6,110,1.2,33,0.4,3401,37.4
E02006469,7073,100,4320,61.1,4138,58.5,182,2.6,98,1.4,69,1,29,0.4,2655,37.5
E02006470,9667,100,5527,57.2,5272,54.5,255,2.6,158,1.6,130,1.3,28,0.3,3982,41.2
E02006471,5909,100,3565,60.3,3440,58.2,125,2.1,82,1.4,65,1.1,17,0.3,2262,38.3
E02006472,8077,100,4951,61.3,4735,58.6,216,2.7,109,1.3,88,1.1,21,0.3,3017,37.4
E02006473,8712,100,5326,61.1,5109,58.6,217,2.5,126,1.4,90,1,36,0.4,3260,37.4
E02006474,5360,100,3180,59.3,3069,57.3,111,2.1,74,1.4,56,1,18,0.3,2106,39.3
E02006475,7667,100,4684,61.1,4519,58.9,165,2.2,138,1.8,99,1.3,39,0.5,2845,37.1
E02006476,7340,100,4583,62.4,4282,58.3,301,4.1,108,1.5,94,1.3,14,0.2,2649,36.1
E02006477,7086,100,4349,61.4,4219,59.5,130,1.8,150,2.1,119,1.7,31,0.4,2587,36.5
E02006478,6729,100,4562,67.8,4418,65.7,144,2.1,110,1.6,81,1.2,29,0.4,2057,30.6
E02006479,7515,100,4523,60.2,4234,56.3,289,3.8,141,1.9,119,1.6,22,0.3,2851,37.9
E02006480,6028,100,3604,59.8,3434,57,170,2.8,112,1.9,87,1.4,25,0.4,2312,38.4
E02006481,5686,100,3313,58.3,3161,55.6,152,2.7,102,1.8,81,1.4,21,0.4,2271,39.9
E02006482,5842,100,3689,63.1,3545,60.7,144,2.5,89,1.5,76,1.3,13,0.2,2064,35.3
E02006483,6337,100,3508,55.4,3284,51.8,224,3.5,133,2.1,108,1.7,25,0.4,2696,42.5
E02006484,6279,100,3853,61.4,3678,58.6,175,2.8,114,1.8,90,1.4,24,0.4,2312,36.8
E02006485,5757,100,3211,55.8,3101,53.9,110,1.9,81,1.4,60,1,21,0.4,2465,42.8
E02006486,5884,100,3417,58.1,3270,55.6,147,2.5,96,1.6,67,1.1,29,0.5,2371,40.3
E02006487,5676,100,3032,53.4,2844,50.1,188,3.3,84,1.5,55,1,29,0.5,2560,45.1
E02006488,5252,100,2571,49,2497,47.5,74,1.4,64,1.2,36,0.7,28,0.5,2617,49.8
E02006489,6375,100,3925,61.6,3740,58.7,185,2.9,138,2.2,110,1.7,28,0.4,2312,36.3
E02006490,6194,100,3706,59.8,3497,56.5,209,3.4,111,1.8,72,1.2,39,0.6,2377,38.4
E02006806,6936,100,4159,60,3951,57,208,3,127,1.8,82,1.2,45,0.6,2650,38.2
E02006493,8548,100,5901,69,5703,66.7,198,2.3,216,2.5,186,2.2,30,0.4,2431,28.4
E02006494,6016,100,3823,63.5,3607,60,216,3.6,123,2,97,1.6,26,0.4,2070,34.4
E02006495,6534,100,3826,58.6,3714,56.8,112,1.7,113,1.7,84,1.3,29,0.4,2595,39.7
E02006496,5876,100,4241,72.2,4063,69.1,178,3,155,2.6,137,2.3,18,0.3,1480,25.2
E02006497,6548,100,4545,69.4,4339,66.3,206,3.1,113,1.7,90,1.4,23,0.4,1890,28.9
E02006498,10665,100,7070,66.3,6833,64.1,237,2.2,252,2.4,207,1.9,45,0.4,3343,31.3
E02006499,5133,100,3358,65.4,3279,63.9,79,1.5,102,2,87,1.7,15,0.3,1673,32.6
E02006500,4958,100,2709,54.6,2630,53,79,1.6,98,2,78,1.6,20,0.4,2151,43.4
E02006501,8129,100,4924,60.6,4757,58.5,167,2.1,159,2,130,1.6,29,0.4,3046,37.5
E02006502,9197,100,4921,53.5,4777,51.9,144,1.6,135,1.5,108,1.2,27,0.3,4141,45
E02006503,8160,100,4774,58.5,4650,57,124,1.5,134,1.6,106,1.3,28,0.3,3252,39.9
E02007048,6375,100,3875,60.8,3788,59.4,87,1.4,79,1.2,64,1,15,0.2,2421,38
E02007049,6057,100,4627,76.4,4508,74.4,119,2,114,1.9,87,1.4,27,0.4,1316,21.7
E02006504,5013,100,2922,58.3,2846,56.8,76,1.5,47,0.9,39,0.8,8,0.2,2044,40.8
E02006505,5956,100,3204,53.8,3114,52.3,90,1.5,78,1.3,56,0.9,22,0.4,2674,44.9
E02006506,4959,100,2851,57.5,2745,55.4,106,2.1,75,1.5,65,1.3,10,0.2,2033,41
E02006507,9096,100,5985,65.8,5807,63.8,178,2,131,1.4,98,1.1,33,0.4,2980,32.8
E02006508,9132,100,5697,62.4,5559,60.9,138,1.5,136,1.5,110,1.2,26,0.3,3299,36.1
E02006509,5000,100,2842,56.8,2743,54.9,99,2,63,1.3,51,1,12,0.2,2095,41.9
E02006510,5839,100,3140,53.8,3063,52.5,77,1.3,58,1,41,0.7,17,0.3,2641,45.2
E02006511,8741,100,5200,59.5,5086,58.2,114,1.3,154,1.8,116,1.3,38,0.4,3387,38.7
E02006512,10417,100,6437,61.8,6210,59.6,227,2.2,132,1.3,106,1,26,0.2,3848,36.9
E02006513,6885,100,4001,58.1,3850,55.9,151,2.2,100,1.5,88,1.3,12,0.2,2784,40.4
E02006514,7661,100,4211,55,4064,53,147,1.9,105,1.4,87,1.1,18,0.2,3345,43.7
E02006515,9210,100,5580,60.6,5388,58.5,192,2.1,128,1.4,112,1.2,16,0.2,3502,38
E02006516,8113,100,5003,61.7,4873,60.1,130,1.6,88,1.1,73,0.9,15,0.2,3022,37.2
E02006517,7921,100,5011,63.3,4883,61.6,128,1.6,112,1.4,95,1.2,17,0.2,2798,35.3
E02006518,8689,100,4934,56.8,4805,55.3,129,1.5,81,0.9,60,0.7,21,0.2,3674,42.3
E02006519,6713,100,3765,56.1,3665,54.6,100,1.5,146,2.2,115,1.7,31,0.5,2802,41.7
E02006520,6999,100,4077,58.3,3953,56.5,124,1.8,121,1.7,107,1.5,14,0.2,2801,40
E02006521,6129,100,3282,53.5,3168,51.7,114,1.9,122,2,84,1.4,38,0.6,2725,44.5
E02006522,4881,100,2984,61.1,2904,59.5,80,1.6,69,1.4,58,1.2,11,0.2,1828,37.5
E02006523,11074,100,5228,47.2,5090,46,138,1.2,460,4.2,271,2.4,189,1.7,5386,48.6
E02006524,4444,100,2695,60.6,2534,57,161,3.6,63,1.4,45,1,18,0.4,1686,37.9
E02006525,11171,100,6324,56.6,6122,54.8,202,1.8,339,3,262,2.3,77,0.7,4508,40.4
E02006526,7199,100,4446,61.8,4261,59.2,185,2.6,100,1.4,81,1.1,19,0.3,2653,36.9
E02006527,7954,100,4794,60.3,4604,57.9,190,2.4,229,2.9,190,2.4,39,0.5,2931,36.8
E02006528,9554,100,5542,58,5299,55.5,243,2.5,370,3.9,302,3.2,68,0.7,3642,38.1
E02006529,10223,100,6759,66.1,6480,63.4,279,2.7,176,1.7,143,1.4,33,0.3,3288,32.2
E02006530,10666,100,6975,65.4,6738,63.2,237,2.2,210,2,169,1.6,41,0.4,3481,32.6
E02006531,8767,100,4524,51.6,4257,48.6,267,3,455,5.2,351,4,104,1.2,3788,43.2
E02006532,9116,100,6041,66.3,5872,64.4,169,1.9,167,1.8,131,1.4,36,0.4,2908,31.9
E02006533,8361,100,5601,67,5388,64.4,213,2.5,129,1.5,101,1.2,28,0.3,2631,31.5
E02006696,5768,100,3422,59.3,3342,57.9,80,1.4,99,1.7,86,1.5,13,0.2,2247,39
E02006697,6281,100,3620,57.6,3516,56,104,1.7,80,1.3,70,1.1,10,0.2,2581,41.1
E02006698,5311,100,3093,58.2,2970,55.9,123,2.3,84,1.6,69,1.3,15,0.3,2134,40.2
E02006699,4800,100,2674,55.7,2548,53.1,126,2.6,34,0.7,22,0.5,12,0.2,2092,43.6
E02006700,5332,100,2954,55.4,2873,53.9,81,1.5,68,1.3,53,1,15,0.3,2310,43.3
E02006701,5963,100,3685,61.8,3593,60.3,92,1.5,93,1.6,77,1.3,16,0.3,2185,36.6
E02006702,4838,100,2940,60.8,2803,57.9,137,2.8,53,1.1,36,0.7,17,0.4,1845,38.1
E02006703,6553,100,3962,60.5,3835,58.5,127,1.9,99,1.5,83,1.3,16,0.2,2492,38
E02006704,5710,100,3234,56.6,3130,54.8,104,1.8,105,1.8,86,1.5,19,0.3,2371,41.5
E02006705,5940,100,3709,62.4,3535,59.5,174,2.9,94,1.6,82,1.4,12,0.2,2137,36
E02006706,5864,100,3132,53.4,2981,50.8,151,2.6,70,1.2,53,0.9,17,0.3,2662,45.4
E02006707,5422,100,3426,63.2,3353,61.8,73,1.3,100,1.8,75,1.4,25,0.5,1896,35
E02006708,6309,100,4080,64.7,3872,61.4,208,3.3,116,1.8,78,1.2,38,0.6,2113,33.5
E02006709,7011,100,4149,59.2,4001,57.1,148,2.1,101,1.4,63,0.9,38,0.5,2761,39.4
E02006710,7114,100,3912,55,3787,53.2,125,1.8,81,1.1,50,0.7,31,0.4,3121,43.9
E02006711,7169,100,4047,56.5,3932,54.8,115,1.6,95,1.3,82,1.1,13,0.2,3027,42.2
E02006712,6460,100,3670,56.8,3563,55.2,107,1.7,76,1.2,64,1,12,0.2,2714,42
E02006713,5408,100,2845,52.6,2717,50.2,128,2.4,51,0.9,38,0.7,13,0.2,2512,46.4
E02006714,5001,100,2677,53.5,2606,52.1,71,1.4,62,1.2,52,1,10,0.2,2262,45.2
E02006715,7194,100,4356,60.6,4175,58,181,2.5,107,1.5,93,1.3,14,0.2,2731,38
E02006716,5093,100,2785,54.7,2605,51.1,180,3.5,56,1.1,49,1,7,0.1,2252,44.2
E02006717,5787,100,3266,56.4,3159,54.6,107,1.8,63,1.1,47,0.8,16,0.3,2458,42.5
E02006718,5173,100,2452,47.4,2329,45,123,2.4,62,1.2,52,1,10,0.2,2659,51.4
E02006719,6465,100,3134,48.5,3007,46.5,127,2,86,1.3,65,1,21,0.3,3245,50.2
E02006720,6250,100,3399,54.4,3275,52.4,124,2,67,1.1,51,0.8,16,0.3,2784,44.5
E02006721,5439,100,3252,59.8,3151,57.9,101,1.9,106,1.9,82,1.5,24,0.4,2081,38.3
E02006722,4214,100,2660,63.1,2479,58.8,181,4.3,80,1.9,60,1.4,20,0.5,1474,35
E02006723,7248,100,4698,64.8,4477,61.8,221,3,127,1.8,97,1.3,30,0.4,2423,33.4
E02006724,5537,100,3446,62.2,3218,58.1,228,4.1,109,2,85,1.5,24,0.4,1982,35.8
E02006725,4481,100,2727,60.9,2566,57.3,161,3.6,56,1.2,40,0.9,16,0.4,1698,37.9
E02006726,5201,100,3299,63.4,3155,60.7,144,2.8,89,1.7,55,1.1,34,0.7,1813,34.9
E02006727,4927,100,3017,61.2,2909,59,108,2.2,68,1.4,52,1.1,16,0.3,1842,37.4
E02006728,6411,100,3998,62.4,3899,60.8,99,1.5,93,1.5,71,1.1,22,0.3,2320,36.2
E02006729,6155,100,3866,62.8,3724,60.5,142,2.3,97,1.6,72,1.2,25,0.4,2192,35.6
E02006730,5121,100,3266,63.8,3081,60.2,185,3.6,85,1.7,76,1.5,9,0.2,1770,34.6
E02006731,4640,100,2794,60.2,2707,58.3,87,1.9,68,1.5,55,1.2,13,0.3,1778,38.3
E02006732,5824,100,3582,61.5,3469,59.6,113,1.9,101,1.7,74,1.3,27,0.5,2141,36.8
E02006733,5053,100,3082,61,2974,58.9,108,2.1,83,1.6,70,1.4,13,0.3,1888,37.4
E02006734,6772,100,4019,59.3,3898,57.6,121,1.8,129,1.9,94,1.4,35,0.5,2624,38.7
E02006735,4190,100,2414,57.6,2196,52.4,218,5.2,60,1.4,45,1.1,15,0.4,1716,41
E02006736,5355,100,3825,71.4,3710,69.3,115,2.1,77,1.4,55,1,22,0.4,1453,27.1
E02006737,6893,100,4403,63.9,4223,61.3,180,2.6,127,1.8,96,1.4,31,0.4,2363,34.3
E02006738,7114,100,4386,61.7,4104,57.7,282,4,148,2.1,121,1.7,27,0.4,2580,36.3
E02006739,5148,100,2139,41.6,2058,40,81,1.6,607,11.8,444,8.6,163,3.2,2402,46.7
E02006740,6606,100,4056,61.4,3812,57.7,244,3.7,321,4.9,237,3.6,84,1.3,2229,33.7
E02006741,4991,100,3420,68.5,3311,66.3,109,2.2,92,1.8,69,1.4,23,0.5,1479,29.6
E02006742,7370,100,3996,54.2,3784,51.3,212,2.9,424,5.8,323,4.4,101,1.4,2950,40
E02006743,5411,100,3396,62.8,3237,59.8,159,2.9,105,1.9,86,1.6,19,0.4,1910,35.3
E02006744,6251,100,3853,61.6,3639,58.2,214,3.4,178,2.8,144,2.3,34,0.5,2220,35.5
E02006745,7312,100,4205,57.5,4049,55.4,156,2.1,171,2.3,127,1.7,44,0.6,2936,40.2
E02006746,7463,100,4706,63.1,4539,60.8,167,2.2,144,1.9,118,1.6,26,0.3,2613,35
E02006747,4737,100,3105,65.5,3035,64.1,70,1.5,97,2,77,1.6,20,0.4,1535,32.4
E02006748,7157,100,4416,61.7,4281,59.8,135,1.9,71,1,55,0.8,16,0.2,2670,37.3
E02006749,4265,100,2477,58.1,2354,55.2,123,2.9,58,1.4,41,1,17,0.4,1730,40.6
E02006750,4633,100,2518,54.3,2419,52.2,99,2.1,42,0.9,31,0.7,11,0.2,2073,44.7
E02006751,4872,100,2651,54.4,2532,52,119,2.4,56,1.1,40,0.8,16,0.3,2165,44.4
E02006752,6838,100,4154,60.7,4030,58.9,124,1.8,123,1.8,103,1.5,20,0.3,2561,37.5
E02006753,6093,100,3603,59.1,3504,57.5,99,1.6,93,1.5,75,1.2,18,0.3,2397,39.3
E02006754,4907,100,2879,58.7,2833,57.7,46,0.9,65,1.3,55,1.1,10,0.2,1963,40
E02006755,5047,100,2789,55.3,2736,54.2,53,1.1,78,1.5,66,1.3,12,0.2,2180,43.2
E02006756,5444,100,3537,65,3446,63.3,91,1.7,92,1.7,70,1.3,22,0.4,1815,33.3
E02006757,6301,100,3388,53.8,3273,51.9,115,1.8,74,1.2,55,0.9,19,0.3,2839,45.1
E02006758,5458,100,3097,56.7,2980,54.6,117,2.1,68,1.2,55,1,13,0.2,2293,42
E02006759,7042,100,3747,53.2,3583,50.9,164,2.3,83,1.2,67,1,16,0.2,3212,45.6
E02006760,7592,100,4264,56.2,4131,54.4,133,1.8,96,1.3,85,1.1,11,0.1,3232,42.6
E02006761,5284,100,3463,65.5,3266,61.8,197,3.7,63,1.2,52,1,11,0.2,1758,33.3
E02006762,5909,100,3639,61.6,3539,59.9,100,1.7,81,1.4,76,1.3,5,0.1,2189,37
E02006763,6886,100,4370,63.5,4262,61.9,108,1.6,130,1.9,100,1.5,30,0.4,2386,34.7
E02006764,4731,100,3071,64.9,2962,62.6,109,2.3,71,1.5,51,1.1,20,0.4,1589,33.6
E02006765,5520,100,2854,51.7,2772,50.2,82,1.5,50,0.9,39,0.7,11,0.2,2616,47.4
E02006766,6733,100,3677,54.6,3579,53.2,98,1.5,66,1,55,0.8,11,0.2,2990,44.4
E02006767,8021,100,4305,53.7,4161,51.9,144,1.8,128,1.6,84,1,44,0.5,3588,44.7
E02006768,5791,100,3290,56.8,3182,54.9,108,1.9,100,1.7,76,1.3,24,0.4,2401,41.5
E02006769,5928,100,3626,61.2,3514,59.3,112,1.9,87,1.5,60,1,27,0.5,2215,37.4
E02006770,6582,100,4001,60.8,3721,56.5,280,4.3,152,2.3,122,1.9,30,0.5,2429,36.9
E02006771,5784,100,2946,50.9,2831,48.9,115,2,62,1.1,44,0.8,18,0.3,2776,48
E02006772,5560,100,3061,55.1,2928,52.7,133,2.4,71,1.3,49,0.9,22,0.4,2428,43.7
E02006773,6859,100,3641,53.1,3432,50,209,3,96,1.4,68,1,28,0.4,3122,45.5
E02006774,6179,100,3858,62.4,3668,59.4,190,3.1,92,1.5,72,1.2,20,0.3,2229,36.1
E02006775,4723,100,2660,56.3,2480,52.5,180,3.8,61,1.3,42,0.9,19,0.4,2002,42.4
E02006776,5369,100,3129,58.3,2986,55.6,143,2.7,83,1.5,56,1,27,0.5,2157,40.2
E02006777,6342,100,3200,50.5,3069,48.4,131,2.1,64,1,48,0.8,16,0.3,3078,48.5
E02006778,5907,100,3289,55.7,3180,53.8,109,1.8,85,1.4,65,1.1,20,0.3,2533,42.9
E02006779,6495,100,3575,55,3436,52.9,139,2.1,82,1.3,63,1,19,0.3,2838,43.7
E02006780,5021,100,2454,48.9,2324,46.3,130,2.6,40,0.8,31,0.6,9,0.2,2527,50.3
E02001827,5188,100,2877,55.5,2763,53.3,114,2.2,101,1.9,69,1.3,32,0.6,2210,42.6
E02001828,5859,100,3173,54.2,3048,52,125,2.1,86,1.5,54,0.9,32,0.5,2600,44.4
E02001829,7139,100,4403,61.7,4259,59.7,144,2,96,1.3,75,1.1,21,0.3,2640,37
E02001830,8122,100,4516,55.6,4396,54.1,120,1.5,112,1.4,82,1,30,0.4,3494,43
E02001831,8333,100,4946,59.4,4650,55.8,296,3.6,150,1.8,113,1.4,37,0.4,3237,38.8
E02001832,6582,100,3898,59.2,3745,56.9,153,2.3,97,1.5,74,1.1,23,0.3,2587,39.3
E02001833,4813,100,2926,60.8,2794,58.1,132,2.7,67,1.4,45,0.9,22,0.5,1820,37.8
E02001834,4648,100,2758,59.3,2560,55.1,198,4.3,113,2.4,79,1.7,34,0.7,1777,38.2
E02001835,6964,100,4300,61.7,4148,59.6,152,2.2,121,1.7,86,1.2,35,0.5,2543,36.5
E02001836,7462,100,4299,57.6,4140,55.5,159,2.1,120,1.6,85,1.1,35,0.5,3043,40.8
E02001837,8005,100,4386,54.8,3903,48.8,483,6,168,2.1,113,1.4,55,0.7,3451,43.1
E02001838,6340,100,3740,59,3634,57.3,106,1.7,97,1.5,77,1.2,20,0.3,2503,39.5
E02001839,5181,100,3044,58.8,2856,55.1,188,3.6,77,1.5,59,1.1,18,0.3,2060,39.8
E02001840,7271,100,3763,51.8,3394,46.7,369,5.1,169,2.3,94,1.3,75,1,3339,45.9
E02001841,5016,100,2683,53.5,2612,52.1,71,1.4,69,1.4,43,0.9,26,0.5,2264,45.1
E02001842,6425,100,3865,60.2,3641,56.7,224,3.5,135,2.1,96,1.5,39,0.6,2425,37.7
E02001843,5299,100,3140,59.3,2927,55.2,213,4,78,1.5,60,1.1,18,0.3,2081,39.3
E02001844,8177,100,4671,57.1,4451,54.4,220,2.7,111,1.4,80,1,31,0.4,3395,41.5
E02001845,5196,100,3346,64.4,3152,60.7,194,3.7,92,1.8,67,1.3,25,0.5,1758,33.8
E02001846,6318,100,3569,56.5,3233,51.2,336,5.3,181,2.9,148,2.3,33,0.5,2568,40.6
E02001847,4574,100,2625,57.4,2503,54.7,122,2.7,68,1.5,55,1.2,13,0.3,1881,41.1
E02001848,5374,100,2853,53.1,2537,47.2,316,5.9,173,3.2,123,2.3,50,0.9,2348,43.7
E02001849,6491,100,3753,57.8,3398,52.3,355,5.5,186,2.9,164,2.5,22,0.3,2552,39.3
E02001850,6631,100,3729,56.2,3420,51.6,309,4.7,208,3.1,162,2.4,46,0.7,2694,40.6
E02001851,7239,100,4194,57.9,3936,54.4,258,3.6,137,1.9,109,1.5,28,0.4,2908,40.2
E02001852,5592,100,3082,55.1,2769,49.5,313,5.6,173,3.1,129,2.3,44,0.8,2337,41.8
E02001855,7736,100,4099,53,3666,47.4,433,5.6,139,1.8,103,1.3,36,0.5,3498,45.2
E02001856,7345,100,4161,56.7,3715,50.6,446,6.1,223,3,157,2.1,66,0.9,2961,40.3
E02001857,11133,100,5937,53.3,5249,47.1,688,6.2,363,3.3,279,2.5,84,0.8,4833,43.4
E02001858,7380,100,3612,48.9,3200,43.4,412,5.6,616,8.3,475,6.4,141,1.9,3152,42.7
E02001859,7668,100,3607,47,3164,41.3,443,5.8,297,3.9,188,2.5,109,1.4,3764,49.1
E02001860,6339,100,3092,48.8,2711,42.8,381,6,227,3.6,147,2.3,80,1.3,3020,47.6
E02001861,8296,100,3922,47.3,3377,40.7,545,6.6,280,3.4,174,2.1,106,1.3,4094,49.3
E02001862,7511,100,3879,51.6,3377,45,502,6.7,263,3.5,135,1.8,128,1.7,3369,44.9
E02001863,6173,100,2742,44.4,2277,36.9,465,7.5,249,4,148,2.4,101,1.6,3182,51.5
E02001865,8596,100,4068,47.3,3397,39.5,671,7.8,301,3.5,199,2.3,102,1.2,4227,49.2
E02001866,7159,100,3271,45.7,2626,36.7,645,9,259,3.6,178,2.5,81,1.1,3629,50.7
E02001867,6221,100,2758,44.3,2329,37.4,429,6.9,259,4.2,165,2.7,94,1.5,3204,51.5
E02001868,7197,100,3697,51.4,3362,46.7,335,4.7,252,3.5,178,2.5,74,1,3248,45.1
E02001869,4650,100,2156,46.4,1778,38.2,378,8.1,203,4.4,117,2.5,86,1.8,2291,49.3
E02001870,9175,100,4360,47.5,3878,42.3,482,5.3,368,4,237,2.6,131,1.4,4447,48.5
E02001871,6388,100,3361,52.6,3029,47.4,332,5.2,125,2,77,1.2,48,0.8,2902,45.4
E02001872,5637,100,3148,55.8,2874,51,274,4.9,84,1.5,48,0.9,36,0.6,2405,42.7
E02001873,8420,100,4058,48.2,3462,41.1,596,7.1,371,4.4,233,2.8,138,1.6,3991,47.4
E02001874,7028,100,3024,43,2579,36.7,445,6.3,262,3.7,171,2.4,91,1.3,3742,53.2
E02001875,6477,100,3406,52.6,2908,44.9,498,7.7,301,4.6,189,2.9,112,1.7,2770,42.8
E02001876,13702,100,3414,24.9,2865,20.9,549,4,2502,18.3,1291,9.4,1211,8.8,7786,56.8
E02001877,8743,100,3498,40,2955,33.8,543,6.2,330,3.8,221,2.5,109,1.2,4915,56.2
E02001878,6811,100,3037,44.6,2570,37.7,467,6.9,318,4.7,226,3.3,92,1.4,3456,50.7
E02001879,7677,100,3497,45.6,3022,39.4,475,6.2,344,4.5,215,2.8,129,1.7,3836,50
E02001880,7086,100,3795,53.6,3356,47.4,439,6.2,170,2.4,112,1.6,58,0.8,3121,44
E02001881,7332,100,3258,44.4,2859,39,399,5.4,272,3.7,158,2.2,114,1.6,3802,51.9
E02001882,6675,100,3316,49.7,3001,45,315,4.7,199,3,152,2.3,47,0.7,3160,47.3
E02001883,6391,100,3485,54.5,3084,48.3,401,6.3,109,1.7,69,1.1,40,0.6,2797,43.8
E02001884,6911,100,3002,43.4,2588,37.4,414,6,273,4,176,2.5,97,1.4,3636,52.6
E02001886,8067,100,4522,56.1,4124,51.1,398,4.9,323,4,221,2.7,102,1.3,3222,39.9
E02001888,5315,100,2744,51.6,2466,46.4,278,5.2,136,2.6,85,1.6,51,1,2435,45.8
E02001889,6471,100,2811,43.4,2426,37.5,385,5.9,250,3.9,186,2.9,64,1,3410,52.7
E02001890,8503,100,4703,55.3,4277,50.3,426,5,488,5.7,349,4.1,139,1.6,3312,39
E02001892,7981,100,3845,48.2,3405,42.7,440,5.5,254,3.2,174,2.2,80,1,3882,48.6
E02001893,6878,100,3621,52.6,3329,48.4,292,4.2,180,2.6,128,1.9,52,0.8,3077,44.7
E02001895,6912,100,3659,52.9,3314,47.9,345,5,166,2.4,115,1.7,51,0.7,3087,44.7
E02001896,7208,100,2982,41.4,2582,35.8,400,5.5,258,3.6,181,2.5,77,1.1,3968,55
E02001897,6264,100,2561,40.9,2132,34,429,6.8,193,3.1,113,1.8,80,1.3,3510,56
E02001898,5328,100,3113,58.4,2950,55.4,163,3.1,117,2.2,81,1.5,36,0.7,2098,39.4
E02001899,6947,100,3986,57.4,3815,54.9,171,2.5,116,1.7,93,1.3,23,0.3,2845,41
E02001900,5391,100,2603,48.3,2275,42.2,328,6.1,301,5.6,187,3.5,114,2.1,2487,46.1
E02001901,6804,100,4423,65,4253,62.5,170,2.5,207,3,170,2.5,37,0.5,2174,32
E02001902,4890,100,2974,60.8,2775,56.7,199,4.1,118,2.4,84,1.7,34,0.7,1798,36.8
E02001903,5843,100,2427,41.5,2025,34.7,402,6.9,208,3.6,132,2.3,76,1.3,3208,54.9
E02001904,5618,100,2920,52,2569,45.7,351,6.2,159,2.8,108,1.9,51,0.9,2539,45.2
E02001905,9187,100,2945,32.1,2794,30.4,151,1.6,856,9.3,494,5.4,362,3.9,5386,58.6
E02001906,7667,100,4555,59.4,4244,55.4,311,4.1,164,2.1,108,1.4,56,0.7,2948,38.5
E02001907,8452,100,5113,60.5,4777,56.5,336,4,172,2,110,1.3,62,0.7,3167,37.5
E02001908,6526,100,2754,42.2,2410,36.9,344,5.3,235,3.6,153,2.3,82,1.3,3537,54.2
E02001909,6015,100,2573,42.8,2206,36.7,367,6.1,151,2.5,115,1.9,36,0.6,3291,54.7
E02001910,5429,100,2324,42.8,1979,36.5,345,6.4,161,3,110,2,51,0.9,2944,54.2
E02001911,6384,100,3201,50.1,2825,44.3,376,5.9,192,3,119,1.9,73,1.1,2991,46.9
E02001913,6278,100,2790,44.4,2519,40.1,271,4.3,445,7.1,320,5.1,125,2,3043,48.5
E02001914,5579,100,2943,52.8,2703,48.4,240,4.3,158,2.8,108,1.9,50,0.9,2478,44.4
E02001915,9530,100,5492,57.6,5037,52.9,455,4.8,194,2,148,1.6,46,0.5,3844,40.3
E02001916,7269,100,3740,51.5,3334,45.9,406,5.6,227,3.1,149,2,78,1.1,3302,45.4
E02001918,7252,100,4188,57.7,3845,53,343,4.7,157,2.2,117,1.6,40,0.6,2907,40.1
E02001919,5720,100,3086,54,2831,49.5,255,4.5,133,2.3,107,1.9,26,0.5,2501,43.7
E02001920,5933,100,3094,52.1,2794,47.1,300,5.1,118,2,69,1.2,49,0.8,2721,45.9
E02001921,6024,100,3337,55.4,3075,51,262,4.3,181,3,139,2.3,42,0.7,2506,41.6
E02001922,15230,100,1685,11.1,1474,9.7,211,1.4,2691,17.7,1797,11.8,894,5.9,10854,71.3
E02001923,8518,100,4138,48.6,3771,44.3,367,4.3,242,2.8,179,2.1,63,0.7,4138,48.6
E02001924,5442,100,3017,55.4,2795,51.4,222,4.1,148,2.7,114,2.1,34,0.6,2277,41.8
E02001925,5493,100,2796,50.9,2617,47.6,179,3.3,205,3.7,155,2.8,50,0.9,2492,45.4
E02001926,6547,100,3395,51.9,3166,48.4,229,3.5,348,5.3,242,3.7,106,1.6,2804,42.8
E02001927,5819,100,3237,55.6,2889,49.6,348,6,161,2.8,107,1.8,54,0.9,2421,41.6
E02001928,5380,100,2846,52.9,2558,47.5,288,5.4,120,2.2,92,1.7,28,0.5,2414,44.9
E02001929,7518,100,4213,56,3794,50.5,419,5.6,188,2.5,132,1.8,56,0.7,3117,41.5
E02001930,6232,100,3901,62.6,3684,59.1,217,3.5,131,2.1,89,1.4,42,0.7,2200,35.3
E02001931,6832,100,3753,54.9,3501,51.2,252,3.7,127,1.9,103,1.5,24,0.4,2952,43.2
E02001932,5567,100,3002,53.9,2703,48.6,299,5.4,160,2.9,106,1.9,54,1,2405,43.2
E02001933,6067,100,3563,58.7,3306,54.5,257,4.2,126,2.1,90,1.5,36,0.6,2378,39.2
E02001934,5554,100,3113,56,2949,53.1,164,3,156,2.8,99,1.8,57,1,2285,41.1
E02001935,6346,100,3512,55.3,3269,51.5,243,3.8,93,1.5,61,1,32,0.5,2741,43.2
E02001936,5119,100,2875,56.2,2716,53.1,159,3.1,81,1.6,64,1.3,17,0.3,2163,42.3
E02001937,6352,100,3364,53,3054,48.1,310,4.9,122,1.9,98,1.5,24,0.4,2866,45.1
E02001938,6451,100,4257,66,4030,62.5,227,3.5,130,2,95,1.5,35,0.5,2064,32
E02001939,5199,100,2475,47.6,2278,43.8,197,3.8,92,1.8,65,1.3,27,0.5,2632,50.6
E02001941,4886,100,2607,53.4,2344,48,263,5.4,88,1.8,59,1.2,29,0.6,2191,44.8
E02001942,5447,100,3162,58.1,2953,54.2,209,3.8,130,2.4,97,1.8,33,0.6,2155,39.6
E02001943,5128,100,2998,58.5,2805,54.7,193,3.8,75,1.5,53,1,22,0.4,2055,40.1
E02001944,6479,100,3902,60.2,3692,57,210,3.2,91,1.4,61,0.9,30,0.5,2486,38.4
E02001945,5907,100,3347,56.7,3029,51.3,318,5.4,140,2.4,90,1.5,50,0.8,2420,41
E02001946,6218,100,3603,57.9,3424,55.1,179,2.9,105,1.7,70,1.1,35,0.6,2510,40.4
E02001947,4657,100,2238,48.1,1927,41.4,311,6.7,109,2.3,75,1.6,34,0.7,2310,49.6
E02001948,5908,100,3609,61.1,3408,57.7,201,3.4,91,1.5,71,1.2,20,0.3,2208,37.4
E02001949,4736,100,2880,60.8,2664,56.2,216,4.6,67,1.4,50,1.1,17,0.4,1789,37.8
E02001950,6966,100,4144,59.5,3934,56.5,210,3,122,1.8,85,1.2,37,0.5,2700,38.8
E02001951,7122,100,3686,51.8,3298,46.3,388,5.4,163,2.3,116,1.6,47,0.7,3273,46
E02001952,6955,100,3642,52.4,3239,46.6,403,5.8,150,2.2,103,1.5,47,0.7,3163,45.5
E02001953,5787,100,3212,55.5,3018,52.2,194,3.4,103,1.8,67,1.2,36,0.6,2472,42.7
E02001954,5692,100,2881,50.6,2579,45.3,302,5.3,103,1.8,72,1.3,31,0.5,2708,47.6
E02001955,6329,100,3816,60.3,3551,56.1,265,4.2,111,1.8,76,1.2,35,0.6,2402,38
E02001956,5404,100,3341,61.8,3145,58.2,196,3.6,105,1.9,69,1.3,36,0.7,1958,36.2
E02001957,6337,100,3810,60.1,3623,57.2,187,3,133,2.1,103,1.6,30,0.5,2394,37.8
E02006807,6440,100,3751,58.2,3599,55.9,152,2.4,149,2.3,125,1.9,24,0.4,2540,39.4
E02006809,8255,100,4775,57.8,4492,54.4,283,3.4,176,2.1,130,1.6,46,0.6,3304,40
E02006895,7734,100,4203,54.3,3750,48.5,453,5.9,725,9.4,413,5.3,312,4,2806,36.3
E02006896,5401,100,3149,58.3,2846,52.7,303,5.6,462,8.6,294,5.4,168,3.1,1790,33.1
E02006897,7108,100,3750,52.8,3279,46.1,471,6.6,607,8.5,399,5.6,208,2.9,2751,38.7
E02006898,6926,100,4877,70.4,4541,65.6,336,4.9,419,6,286,4.1,133,1.9,1630,23.5
E02006899,5847,100,4010,68.6,3723,63.7,287,4.9,417,7.1,292,5,125,2.1,1420,24.3
E02006900,11096,100,4919,44.3,4233,38.1,686,6.2,467,4.2,301,2.7,166,1.5,5710,51.5
E02007038,10291,100,5675,55.1,5160,50.1,515,5,229,2.2,163,1.6,66,0.6,4387,42.6
E02007039,5995,100,2696,45,2361,39.4,335,5.6,156,2.6,102,1.7,54,0.9,3143,52.4
E02007040,5190,100,2348,45.2,2098,40.4,250,4.8,182,3.5,117,2.3,65,1.3,2660,51.3
E02001958,6427,100,3918,61,3701,57.6,217,3.4,172,2.7,123,1.9,49,0.8,2337,36.4
E02001959,5463,100,3308,60.6,3106,56.9,202,3.7,137,2.5,97,1.8,40,0.7,2018,36.9
E02001961,6091,100,3391,55.7,3102,50.9,289,4.7,191,3.1,148,2.4,43,0.7,2509,41.2
E02001962,5404,100,3248,60.1,3005,55.6,243,4.5,194,3.6,151,2.8,43,0.8,1962,36.3
E02001963,5047,100,2928,58,2800,55.5,128,2.5,144,2.9,110,2.2,34,0.7,1975,39.1
E02001964,7821,100,4439,56.8,4109,52.5,330,4.2,305,3.9,224,2.9,81,1,3077,39.3
E02001965,6544,100,3898,59.6,3736,57.1,162,2.5,140,2.1,107,1.6,33,0.5,2506,38.3
E02001966,5416,100,2846,52.5,2587,47.8,259,4.8,225,4.2,174,3.2,51,0.9,2345,43.3
E02001967,5759,100,3276,56.9,3161,54.9,115,2,96,1.7,66,1.1,30,0.5,2387,41.4
E02001968,6009,100,3689,61.4,3458,57.5,231,3.8,169,2.8,118,2,51,0.8,2151,35.8
E02001969,5316,100,2992,56.3,2804,52.7,188,3.5,165,3.1,151,2.8,14,0.3,2159,40.6
E02001970,4695,100,2710,57.7,2560,54.5,150,3.2,87,1.9,66,1.4,21,0.4,1898,40.4
E02001971,4925,100,3071,62.4,2947,59.8,124,2.5,103,2.1,77,1.6,26,0.5,1751,35.6
E02001972,8506,100,4544,53.4,4037,47.5,507,6,432,5.1,322,3.8,110,1.3,3530,41.5
E02001973,6633,100,3847,58,3520,53.1,327,4.9,287,4.3,232,3.5,55,0.8,2499,37.7
E02001974,7697,100,4868,63.2,4664,60.6,204,2.7,171,2.2,133,1.7,38,0.5,2658,34.5
E02001975,5996,100,3883,64.8,3715,62,168,2.8,175,2.9,127,2.1,48,0.8,1938,32.3
E02001976,5960,100,3411,57.2,3235,54.3,176,3,145,2.4,111,1.9,34,0.6,2404,40.3
E02001977,8169,100,4312,52.8,3875,47.4,437,5.3,516,6.3,349,4.3,167,2,3341,40.9
E02001978,5326,100,3285,61.7,3119,58.6,166,3.1,146,2.7,104,2,42,0.8,1895,35.6
E02001979,4633,100,2796,60.3,2686,58,110,2.4,80,1.7,66,1.4,14,0.3,1757,37.9
E02001980,4926,100,2670,54.2,2593,52.6,77,1.6,74,1.5,48,1,26,0.5,2182,44.3
E02001981,10420,100,4083,39.2,3547,34,536,5.1,1286,12.3,745,7.1,541,5.2,5051,48.5
E02001982,6818,100,4270,62.6,4117,60.4,153,2.2,133,2,99,1.5,34,0.5,2415,35.4
E02001983,6249,100,3794,60.7,3601,57.6,193,3.1,151,2.4,105,1.7,46,0.7,2304,36.9
E02001984,8287,100,5110,61.7,4825,58.2,285,3.4,332,4,246,3,86,1,2845,34.3
E02001985,8218,100,2707,32.9,2351,28.6,356,4.3,1414,17.2,943,11.5,471,5.7,4097,49.9
E02001986,6363,100,3611,56.7,3329,52.3,282,4.4,136,2.1,101,1.6,35,0.6,2616,41.1
E02001987,5207,100,2679,51.4,2520,48.4,159,3.1,400,7.7,330,6.3,70,1.3,2128,40.9
E02001988,10343,100,2741,26.5,2487,24,254,2.5,1881,18.2,1043,10.1,838,8.1,5721,55.3
E02001989,5037,100,2972,59,2834,56.3,138,2.7,188,3.7,127,2.5,61,1.2,1877,37.3
E02001990,7541,100,4574,60.7,4401,58.4,173,2.3,142,1.9,111,1.5,31,0.4,2825,37.5
E02001991,7276,100,3904,53.7,3774,51.9,130,1.8,211,2.9,156,2.1,55,0.8,3161,43.4
E02001992,8115,100,4657,57.4,4327,53.3,330,4.1,254,3.1,189,2.3,65,0.8,3204,39.5
E02001993,7397,100,3388,45.8,3141,42.5,247,3.3,446,6,306,4.1,140,1.9,3563,48.2
E02001994,6449,100,3791,58.8,3579,55.5,212,3.3,162,2.5,130,2,32,0.5,2496,38.7
E02001995,7610,100,4653,61.1,4359,57.3,294,3.9,353,4.6,242,3.2,111,1.5,2604,34.2
E02001996,5744,100,3192,55.6,2892,50.3,300,5.2,179,3.1,132,2.3,47,0.8,2373,41.3
E02001997,7015,100,4026,57.4,3854,54.9,172,2.5,125,1.8,91,1.3,34,0.5,2864,40.8
E02001998,4896,100,2839,58,2750,56.2,89,1.8,88,1.8,60,1.2,28,0.6,1969,40.2
E02001999,8240,100,2317,28.1,2227,27,90,1.1,695,8.4,443,5.4,252,3.1,5228,63.4
E02006805,6894,100,4098,59.4,3834,55.6,264,3.8,229,3.3,190,2.8,39,0.6,2567,37.2
E02002000,6808,100,3841,56.4,3560,52.3,281,4.1,139,2,88,1.3,51,0.7,2828,41.5
E02002001,5016,100,3007,59.9,2856,56.9,151,3,73,1.5,59,1.2,14,0.3,1936,38.6
E02002002,5948,100,3024,50.8,2908,48.9,116,2,68,1.1,52,0.9,16,0.3,2856,48
E02002003,7435,100,4257,57.3,4044,54.4,213,2.9,90,1.2,58,0.8,32,0.4,3088,41.5
E02002004,6037,100,3467,57.4,3236,53.6,231,3.8,88,1.5,58,1,30,0.5,2482,41.1
E02002005,7277,100,4072,56,3721,51.1,351,4.8,162,2.2,117,1.6,45,0.6,3043,41.8
E02002006,5190,100,3030,58.4,2838,54.7,192,3.7,82,1.6,61,1.2,21,0.4,2078,40
E02002007,7511,100,4221,56.2,4060,54.1,161,2.1,96,1.3,63,0.8,33,0.4,3194,42.5
E02002008,6735,100,4457,66.2,4286,63.6,171,2.5,124,1.8,90,1.3,34,0.5,2154,32
E02002009,5305,100,2878,54.3,2588,48.8,290,5.5,112,2.1,86,1.6,26,0.5,2315,43.6
E02002010,6581,100,3652,55.5,3270,49.7,382,5.8,155,2.4,112,1.7,43,0.7,2774,42.2
E02002011,4980,100,2825,56.7,2718,54.6,107,2.1,83,1.7,59,1.2,24,0.5,2072,41.6
E02002012,6720,100,3572,53.2,3265,48.6,307,4.6,175,2.6,135,2,40,0.6,2973,44.2
E02002013,5632,100,2951,52.4,2839,50.4,112,2,69,1.2,46,0.8,23,0.4,2612,46.4
E02002014,6312,100,3536,56,3265,51.7,271,4.3,152,2.4,108,1.7,44,0.7,2624,41.6
E02002015,5708,100,3537,62,3389,59.4,148,2.6,66,1.2,42,0.7,24,0.4,2105,36.9
E02002016,6198,100,3424,55.2,3133,50.5,291,4.7,102,1.6,67,1.1,35,0.6,2672,43.1
E02002017,6442,100,3567,55.4,3301,51.2,266,4.1,113,1.8,84,1.3,29,0.5,2762,42.9
E02002018,7496,100,4077,54.4,3924,52.3,153,2,138,1.8,97,1.3,41,0.5,3281,43.8
E02002019,6054,100,3393,56,3148,52,245,4,112,1.9,78,1.3,34,0.6,2549,42.1
E02002020,7970,100,4685,58.8,4515,56.6,170,2.1,110,1.4,85,1.1,25,0.3,3175,39.8
E02002021,6238,100,3621,58,3209,51.4,412,6.6,125,2,84,1.3,41,0.7,2492,39.9
E02002022,6937,100,4404,63.5,4136,59.6,268,3.9,108,1.6,69,1,39,0.6,2425,35
E02002023,4484,100,2629,58.6,2529,56.4,100,2.2,73,1.6,54,1.2,19,0.4,1782,39.7
E02002024,7057,100,4265,60.4,4055,57.5,210,3,111,1.6,74,1,37,0.5,2681,38
E02002025,7055,100,4231,60,4005,56.8,226,3.2,151,2.1,113,1.6,38,0.5,2673,37.9
E02002026,5669,100,3364,59.3,3229,57,135,2.4,77,1.4,43,0.8,34,0.6,2228,39.3
E02002027,4574,100,2953,64.6,2862,62.6,91,2,86,1.9,64,1.4,22,0.5,1535,33.6
E02002028,4842,100,2737,56.5,2613,54,124,2.6,64,1.3,42,0.9,22,0.5,2041,42.2
E02002029,5115,100,2895,56.6,2765,54.1,130,2.5,78,1.5,57,1.1,21,0.4,2142,41.9
E02002030,5501,100,3200,58.2,3010,54.7,190,3.5,78,1.4,60,1.1,18,0.3,2223,40.4
E02002031,5108,100,2941,57.6,2776,54.3,165,3.2,96,1.9,73,1.4,23,0.5,2071,40.5
E02002032,8106,100,4763,58.8,4496,55.5,267,3.3,146,1.8,110,1.4,36,0.4,3197,39.4
E02002033,6369,100,3728,58.5,3569,56,159,2.5,96,1.5,69,1.1,27,0.4,2545,40
E02002034,6812,100,4093,60.1,3866,56.8,227,3.3,90,1.3,62,0.9,28,0.4,2629,38.6
E02002035,5077,100,2801,55.2,2714,53.5,87,1.7,52,1,31,0.6,21,0.4,2224,43.8
E02002036,5312,100,2881,54.2,2588,48.7,293,5.5,68,1.3,50,0.9,18,0.3,2363,44.5
E02002037,4902,100,2780,56.7,2625,53.5,155,3.2,84,1.7,35,0.7,49,1,2038,41.6
E02002038,7942,100,4471,56.3,4206,53,265,3.3,140,1.8,102,1.3,38,0.5,3331,41.9
E02002039,5135,100,2887,56.2,2758,53.7,129,2.5,90,1.8,58,1.1,32,0.6,2158,42
E02002040,5030,100,2628,52.2,2561,50.9,67,1.3,61,1.2,41,0.8,20,0.4,2341,46.5
E02002041,5206,100,2597,49.9,2487,47.8,110,2.1,70,1.3,48,0.9,22,0.4,2539,48.8
E02002042,6645,100,3793,57.1,3644,54.8,149,2.2,108,1.6,84,1.3,24,0.4,2744,41.3
E02002043,6805,100,3814,56,3550,52.2,264,3.9,164,2.4,87,1.3,77,1.1,2827,41.5
E02002044,6185,100,3740,60.5,3472,56.1,268,4.3,135,2.2,101,1.6,34,0.5,2310,37.3
E02002045,6128,100,3527,57.6,3311,54,216,3.5,88,1.4,63,1,25,0.4,2513,41
E02002046,4152,100,2192,52.8,1965,47.3,227,5.5,70,1.7,47,1.1,23,0.6,1890,45.5
E02002047,6152,100,3018,49.1,2739,44.5,279,4.5,77,1.3,56,0.9,21,0.3,3057,49.7
E02002048,5716,100,3298,57.7,3150,55.1,148,2.6,96,1.7,79,1.4,17,0.3,2322,40.6
E02002049,4976,100,2964,59.6,2712,54.5,252,5.1,82,1.6,59,1.2,23,0.5,1930,38.8
E02002051,4504,100,2425,53.8,2175,48.3,250,5.6,107,2.4,69,1.5,38,0.8,1972,43.8
E02002052,8803,100,4910,55.8,4488,51,422,4.8,206,2.3,143,1.6,63,0.7,3687,41.9
E02002053,5067,100,2861,56.5,2686,53,175,3.5,125,2.5,95,1.9,30,0.6,2081,41.1
E02002054,4732,100,2647,55.9,2496,52.7,151,3.2,97,2,66,1.4,31,0.7,1988,42
E02002055,8635,100,4816,55.8,4459,51.6,357,4.1,205,2.4,159,1.8,46,0.5,3614,41.9
E02002056,7463,100,4173,55.9,3774,50.6,399,5.3,192,2.6,109,1.5,83,1.1,3098,41.5
E02002057,8406,100,4641,55.2,4171,49.6,470,5.6,190,2.3,126,1.5,64,0.8,3575,42.5
E02002058,10589,100,6381,60.3,5911,55.8,470,4.4,255,2.4,189,1.8,66,0.6,3953,37.3
E02002059,9410,100,5097,54.2,4651,49.4,446,4.7,199,2.1,117,1.2,82,0.9,4114,43.7
E02002060,5487,100,2837,51.7,2538,46.3,299,5.4,167,3,99,1.8,68,1.2,2483,45.3
E02002061,5477,100,2678,48.9,2427,44.3,251,4.6,180,3.3,96,1.8,84,1.5,2619,47.8
E02002062,7050,100,3660,51.9,3211,45.5,449,6.4,190,2.7,146,2.1,44,0.6,3200,45.4
E02002063,7944,100,4819,60.7,4490,56.5,329,4.1,213,2.7,142,1.8,71,0.9,2912,36.7
E02002064,9662,100,5911,61.2,5506,57,405,4.2,197,2,137,1.4,60,0.6,3554,36.8
E02002065,10566,100,5344,50.6,4789,45.3,555,5.3,471,4.5,332,3.1,139,1.3,4751,45
E02002066,6257,100,3208,51.3,2870,45.9,338,5.4,201,3.2,140,2.2,61,1,2848,45.5
E02002067,5021,100,2866,57.1,2710,54,156,3.1,69,1.4,49,1,20,0.4,2086,41.5
E02002069,5676,100,3046,53.7,2786,49.1,260,4.6,229,4,178,3.1,51,0.9,2401,42.3
E02002070,7720,100,3805,49.3,3427,44.4,378,4.9,293,3.8,202,2.6,91,1.2,3622,46.9
E02002071,5256,100,2893,55,2673,50.9,220,4.2,76,1.4,40,0.8,36,0.7,2287,43.5
E02002072,7158,100,4241,59.2,3905,54.6,336,4.7,157,2.2,111,1.6,46,0.6,2760,38.6
E02002073,6376,100,3392,53.2,3113,48.8,279,4.4,187,2.9,138,2.2,49,0.8,2797,43.9
E02002074,6515,100,3679,56.5,3424,52.6,255,3.9,132,2,97,1.5,35,0.5,2704,41.5
E02002075,7082,100,4026,56.8,3732,52.7,294,4.2,128,1.8,102,1.4,26,0.4,2928,41.3
E02002076,8496,100,5580,65.7,5164,60.8,416,4.9,201,2.4,137,1.6,64,0.8,2715,32
E02002077,8674,100,4924,56.8,4566,52.6,358,4.1,149,1.7,92,1.1,57,0.7,3601,41.5
E02002078,5291,100,3119,58.9,2962,56,157,3,136,2.6,94,1.8,42,0.8,2036,38.5
E02002079,6853,100,3888,56.7,3671,53.6,217,3.2,114,1.7,65,0.9,49,0.7,2851,41.6
E02002080,5786,100,3390,58.6,3140,54.3,250,4.3,92,1.6,64,1.1,28,0.5,2304,39.8
E02006810,8781,100,4883,55.6,4533,51.6,350,4,202,2.3,156,1.8,46,0.5,3696,42.1
E02006943,5486,100,2827,51.5,2485,45.3,342,6.2,239,4.4,164,3,75,1.4,2420,44.1
E02006944,5697,100,3131,55,2741,48.1,390,6.8,237,4.2,152,2.7,85,1.5,2329,40.9
E02002081,4599,100,2476,53.8,2364,51.4,112,2.4,64,1.4,45,1,19,0.4,2059,44.8
E02002082,4403,100,2449,55.6,2218,50.4,231,5.2,69,1.6,45,1,24,0.5,1885,42.8
E02002083,5042,100,2969,58.9,2838,56.3,131,2.6,80,1.6,57,1.1,23,0.5,1993,39.5
E02002084,5103,100,2861,56.1,2628,51.5,233,4.6,78,1.5,57,1.1,21,0.4,2164,42.4
E02002085,5073,100,2880,56.8,2644,52.1,236,4.7,99,2,69,1.4,30,0.6,2094,41.3
E02002086,4598,100,2460,53.5,2233,48.6,227,4.9,60,1.3,40,0.9,20,0.4,2078,45.2
E02002087,4742,100,2664,56.2,2405,50.7,259,5.5,72,1.5,47,1,25,0.5,2006,42.3
E02002088,7324,100,4001,54.6,3585,48.9,416,5.7,127,1.7,95,1.3,32,0.4,3196,43.6
E02002089,6666,100,3909,58.6,3698,55.5,211,3.2,88,1.3,68,1,20,0.3,2669,40
E02002090,4801,100,2991,62.3,2857,59.5,134,2.8,81,1.7,63,1.3,18,0.4,1729,36
E02002091,6242,100,3703,59.3,3534,56.6,169,2.7,115,1.8,86,1.4,29,0.5,2424,38.8
E02002092,5912,100,3377,57.1,3213,54.3,164,2.8,94,1.6,67,1.1,27,0.5,2441,41.3
E02002093,5585,100,3171,56.8,3002,53.8,169,3,93,1.7,76,1.4,17,0.3,2321,41.6
E02002094,4993,100,2750,55.1,2653,53.1,97,1.9,84,1.7,63,1.3,21,0.4,2159,43.2
E02002095,7079,100,4163,58.8,3982,56.3,181,2.6,111,1.6,82,1.2,29,0.4,2805,39.6
E02002096,8448,100,4619,54.7,4442,52.6,177,2.1,121,1.4,85,1,36,0.4,3708,43.9
E02002097,6110,100,3592,58.8,3472,56.8,120,2,70,1.1,53,0.9,17,0.3,2448,40.1
E02002098,7773,100,4590,59.1,4421,56.9,169,2.2,124,1.6,102,1.3,22,0.3,3059,39.4
E02002099,5704,100,3144,55.1,3046,53.4,98,1.7,75,1.3,60,1.1,15,0.3,2485,43.6
E02002101,5188,100,3019,58.2,2870,55.3,149,2.9,53,1,38,0.7,15,0.3,2116,40.8
E02002102,7026,100,4183,59.5,4021,57.2,162,2.3,89,1.3,67,1,22,0.3,2754,39.2
E02002103,5114,100,2797,54.7,2698,52.8,99,1.9,56,1.1,41,0.8,15,0.3,2261,44.2
E02002104,4879,100,2876,58.9,2787,57.1,89,1.8,66,1.4,46,0.9,20,0.4,1937,39.7
E02002105,6791,100,3909,57.6,3788,55.8,121,1.8,128,1.9,110,1.6,18,0.3,2754,40.6
E02002106,7986,100,4182,52.4,4062,50.9,120,1.5,118,1.5,83,1,35,0.4,3686,46.2
E02002107,4491,100,2669,59.4,2579,57.4,90,2,71,1.6,52,1.2,19,0.4,1751,39
E02002108,7849,100,4400,56.1,4256,54.2,144,1.8,133,1.7,89,1.1,44,0.6,3316,42.2
E02002109,9633,100,6567,68.2,6365,66.1,202,2.1,146,1.5,107,1.1,39,0.4,2920,30.3
E02006808,5340,100,3424,64.1,3307,61.9,117,2.2,98,1.8,71,1.3,27,0.5,1818,34
E02002110,5635,100,3499,62.1,3358,59.6,141,2.5,92,1.6,57,1,35,0.6,2044,36.3
E02002111,5123,100,2765,54,2554,49.9,211,4.1,82,1.6,56,1.1,26,0.5,2276,44.4
E02002112,4372,100,2487,56.9,2379,54.4,108,2.5,71,1.6,53,1.2,18,0.4,1814,41.5
E02002113,5169,100,3031,58.6,2872,55.6,159,3.1,89,1.7,63,1.2,26,0.5,2049,39.6
E02002114,5099,100,2769,54.3,2643,51.8,126,2.5,60,1.2,44,0.9,16,0.3,2270,44.5
E02002115,5468,100,2903,53.1,2636,48.2,267,4.9,83,1.5,52,1,31,0.6,2482,45.4
E02002116,5716,100,3187,55.8,3082,53.9,105,1.8,80,1.4,64,1.1,16,0.3,2449,42.8
E02002117,5216,100,2962,56.8,2814,53.9,148,2.8,83,1.6,60,1.2,23,0.4,2171,41.6
E02002118,5740,100,3180,55.4,2867,49.9,313,5.5,100,1.7,69,1.2,31,0.5,2460,42.9
E02002119,4902,100,2873,58.6,2734,55.8,139,2.8,73,1.5,54,1.1,19,0.4,1956,39.9
E02002120,4954,100,2901,58.6,2754,55.6,147,3,91,1.8,55,1.1,36,0.7,1962,39.6
E02002121,5044,100,2661,52.8,2401,47.6,260,5.2,73,1.4,42,0.8,31,0.6,2310,45.8
E02002122,5051,100,2854,56.5,2593,51.3,261,5.2,116,2.3,77,1.5,39,0.8,2081,41.2
E02002123,5202,100,2956,56.8,2752,52.9,204,3.9,83,1.6,65,1.2,18,0.3,2163,41.6
E02002124,5784,100,3103,53.6,2938,50.8,165,2.9,61,1.1,37,0.6,24,0.4,2620,45.3
E02002125,5134,100,2970,57.8,2817,54.9,153,3,67,1.3,55,1.1,12,0.2,2097,40.8
E02002126,4967,100,2628,52.9,2382,48,246,5,79,1.6,54,1.1,25,0.5,2260,45.5
E02002127,7134,100,3862,54.1,3503,49.1,359,5,228,3.2,140,2,88,1.2,3044,42.7
E02002128,4635,100,2459,53.1,2329,50.2,130,2.8,68,1.5,44,0.9,24,0.5,2108,45.5
E02002129,5011,100,2786,55.6,2635,52.6,151,3,78,1.6,57,1.1,21,0.4,2147,42.8
E02002130,5144,100,2794,54.3,2571,50,223,4.3,104,2,80,1.6,24,0.5,2246,43.7
E02002131,6525,100,3726,57.1,3591,55,135,2.1,107,1.6,76,1.2,31,0.5,2692,41.3
E02002132,4938,100,2735,55.4,2512,50.9,223,4.5,97,2,65,1.3,32,0.6,2106,42.6
E02002133,5718,100,3177,55.6,2922,51.1,255,4.5,98,1.7,73,1.3,25,0.4,2443,42.7
E02002134,7101,100,4081,57.5,3739,52.7,342,4.8,160,2.3,117,1.6,43,0.6,2860,40.3
E02002135,5983,100,3135,52.4,2807,46.9,328,5.5,191,3.2,149,2.5,42,0.7,2657,44.4
E02002136,6277,100,3692,58.8,3411,54.3,281,4.5,129,2.1,105,1.7,24,0.4,2456,39.1
E02002137,5104,100,2866,56.2,2780,54.5,86,1.7,68,1.3,48,0.9,20,0.4,2170,42.5
E02002138,5063,100,2852,56.3,2674,52.8,178,3.5,121,2.4,95,1.9,26,0.5,2090,41.3
E02002139,8425,100,4187,49.7,3691,43.8,496,5.9,377,4.5,260,3.1,117,1.4,3861,45.8
E02002140,6361,100,3225,50.7,2930,46.1,295,4.6,202,3.2,152,2.4,50,0.8,2934,46.1
E02002141,5291,100,3201,60.5,3088,58.4,113,2.1,64,1.2,45,0.9,19,0.4,2026,38.3
E02002142,5543,100,2989,53.9,2667,48.1,322,5.8,148,2.7,112,2,36,0.6,2406,43.4
E02002143,7361,100,3546,48.2,3128,42.5,418,5.7,210,2.9,147,2,63,0.9,3605,49
E02002144,5666,100,3189,56.3,3053,53.9,136,2.4,83,1.5,65,1.1,18,0.3,2394,42.3
E02002145,6174,100,3586,58.1,3252,52.7,334,5.4,150,2.4,101,1.6,49,0.8,2438,39.5
E02002146,4973,100,2644,53.2,2457,49.4,187,3.8,136,2.7,95,1.9,41,0.8,2193,44.1
E02002147,6814,100,3860,56.6,3539,51.9,321,4.7,122,1.8,80,1.2,42,0.6,2832,41.6
E02002148,9321,100,5691,61.1,5496,59,195,2.1,186,2,137,1.5,49,0.5,3444,36.9
E02002149,8180,100,4582,56,4274,52.2,308,3.8,160,2,122,1.5,38,0.5,3438,42
E02002150,4580,100,2681,58.5,2483,54.2,198,4.3,115,2.5,76,1.7,39,0.9,1784,39
E02002151,4416,100,2609,59.1,2356,53.4,253,5.7,81,1.8,60,1.4,21,0.5,1726,39.1
E02002152,4677,100,2532,54.1,2268,48.5,264,5.6,97,2.1,61,1.3,36,0.8,2048,43.8
E02002153,6109,100,3429,56.1,3218,52.7,211,3.5,103,1.7,77,1.3,26,0.4,2577,42.2
E02002154,5730,100,3705,64.7,3471,60.6,234,4.1,137,2.4,83,1.4,54,0.9,1888,32.9
E02002155,4521,100,2451,54.2,2160,47.8,291,6.4,140,3.1,86,1.9,54,1.2,1930,42.7
E02002156,6665,100,3987,59.8,3755,56.3,232,3.5,129,1.9,78,1.2,51,0.8,2549,38.2
E02002157,6374,100,3886,61,3705,58.1,181,2.8,106,1.7,69,1.1,37,0.6,2382,37.4
E02002158,6138,100,3400,55.4,3136,51.1,264,4.3,78,1.3,56,0.9,22,0.4,2660,43.3
E02002159,4533,100,2569,56.7,2282,50.3,287,6.3,168,3.7,114,2.5,54,1.2,1796,39.6
E02002160,6089,100,3532,58,3338,54.8,194,3.2,85,1.4,55,0.9,30,0.5,2472,40.6
E02002161,5261,100,3055,58.1,2788,53,267,5.1,194,3.7,139,2.6,55,1,2012,38.2
E02002162,6567,100,3408,51.9,3248,49.5,160,2.4,102,1.6,78,1.2,24,0.4,3057,46.6
E02002163,8948,100,5074,56.7,4452,49.8,622,7,284,3.2,201,2.2,83,0.9,3590,40.1
E02002164,5288,100,2467,46.7,2058,38.9,409,7.7,509,9.6,327,6.2,182,3.4,2312,43.7
E02002165,6559,100,3879,59.1,3411,52,468,7.1,220,3.4,128,2,92,1.4,2460,37.5
E02002166,7253,100,3843,53,3418,47.1,425,5.9,167,2.3,122,1.7,45,0.6,3243,44.7
E02002167,5527,100,3145,56.9,2969,53.7,176,3.2,71,1.3,48,0.9,23,0.4,2311,41.8
E02002168,9262,100,4703,50.8,4044,43.7,659,7.1,698,7.5,446,4.8,252,2.7,3861,41.7
E02002169,7322,100,3991,54.5,3819,52.2,172,2.3,133,1.8,101,1.4,32,0.4,3198,43.7
E02002170,4985,100,2736,54.9,2534,50.8,202,4.1,105,2.1,68,1.4,37,0.7,2144,43
E02002171,6030,100,3233,53.6,2944,48.8,289,4.8,129,2.1,90,1.5,39,0.6,2668,44.2
E02002174,6349,100,3732,58.8,3504,55.2,228,3.6,109,1.7,71,1.1,38,0.6,2508,39.5
E02002175,6079,100,3273,53.8,2933,48.2,340,5.6,159,2.6,104,1.7,55,0.9,2647,43.5
E02002176,6240,100,3571,57.2,3318,53.2,253,4.1,104,1.7,62,1,42,0.7,2565,41.1
E02002177,8788,100,5287,60.2,4757,54.1,530,6,251,2.9,191,2.2,60,0.7,3250,37
E02002178,6746,100,3795,56.3,3540,52.5,255,3.8,136,2,94,1.4,42,0.6,2815,41.7
E02002179,5325,100,3131,58.8,2992,56.2,139,2.6,52,1,37,0.7,15,0.3,2142,40.2
E02002180,5242,100,2908,55.5,2706,51.6,202,3.9,126,2.4,91,1.7,35,0.7,2208,42.1
E02002181,6442,100,3785,58.8,3494,54.2,291,4.5,137,2.1,98,1.5,39,0.6,2520,39.1
E02002182,5342,100,3044,57,2808,52.6,236,4.4,108,2,68,1.3,40,0.7,2190,41
E02006894,10869,100,5974,55,5343,49.2,631,5.8,402,3.7,290,2.7,112,1,4493,41.3
E02003237,5222,100,2896,55.5,2819,54,77,1.5,83,1.6,55,1.1,28,0.5,2243,43
E02003238,4665,100,3009,64.5,2888,61.9,121,2.6,64,1.4,55,1.2,9,0.2,1592,34.1
E02003239,6919,100,4178,60.4,4048,58.5,130,1.9,115,1.7,73,1.1,42,0.6,2626,38
E02003240,5445,100,3602,66.2,3497,64.2,105,1.9,80,1.5,66,1.2,14,0.3,1763,32.4
E02003241,5826,100,3637,62.4,3496,60,141,2.4,74,1.3,47,0.8,27,0.5,2115,36.3
E02003242,7003,100,3971,56.7,3798,54.2,173,2.5,85,1.2,57,0.8,28,0.4,2947,42.1
E02003243,8937,100,5521,61.8,5141,57.5,380,4.3,180,2,120,1.3,60,0.7,3236,36.2
E02003244,7412,100,4186,56.5,3944,53.2,242,3.3,160,2.2,121,1.6,39,0.5,3066,41.4
E02003245,6084,100,3697,60.8,3432,56.4,265,4.4,135,2.2,96,1.6,39,0.6,2252,37
E02003246,7703,100,4308,55.9,3966,51.5,342,4.4,130,1.7,96,1.2,34,0.4,3265,42.4
E02003247,6854,100,4105,59.9,3839,56,266,3.9,128,1.9,97,1.4,31,0.5,2621,38.2
E02003248,8720,100,4935,56.6,4637,53.2,298,3.4,237,2.7,175,2,62,0.7,3548,40.7
E02003249,9673,100,5958,61.6,5585,57.7,373,3.9,162,1.7,129,1.3,33,0.3,3553,36.7
E02003250,9533,100,6003,63,5573,58.5,430,4.5,222,2.3,182,1.9,40,0.4,3308,34.7
E02003251,6497,100,3432,52.8,3304,50.9,128,2,114,1.8,83,1.3,31,0.5,2951,45.4
E02003252,9498,100,6396,67.3,6034,63.5,362,3.8,179,1.9,137,1.4,42,0.4,2923,30.8
E02003253,8203,100,5548,67.6,5268,64.2,280,3.4,138,1.7,109,1.3,29,0.4,2517,30.7
E02003254,7681,100,4508,58.7,4385,57.1,123,1.6,109,1.4,84,1.1,25,0.3,3064,39.9
E02003255,10633,100,6991,65.7,6714,63.1,277,2.6,180,1.7,141,1.3,39,0.4,3462,32.6
E02003257,7232,100,4354,60.2,4049,56,305,4.2,147,2,118,1.6,29,0.4,2731,37.8
E02006877,8449,100,5778,68.4,5545,65.6,233,2.8,147,1.7,109,1.3,38,0.4,2524,29.9
E02006878,9372,100,6961,74.3,6679,71.3,282,3,255,2.7,177,1.9,78,0.8,2156,23
E02003258,7094,100,4418,62.3,4252,59.9,166,2.3,123,1.7,105,1.5,18,0.3,2553,36
E02003259,5246,100,3167,60.4,2984,56.9,183,3.5,132,2.5,96,1.8,36,0.7,1947,37.1
E02003260,6537,100,3768,57.6,3465,53,303,4.6,219,3.4,162,2.5,57,0.9,2550,39
E02003261,5226,100,2872,55,2699,51.6,173,3.3,113,2.2,90,1.7,23,0.4,2241,42.9
E02003262,8498,100,4800,56.5,4437,52.2,363,4.3,242,2.8,172,2,70,0.8,3456,40.7
E02003263,9919,100,5761,58.1,5408,54.5,353,3.6,253,2.6,171,1.7,82,0.8,3905,39.4
E02003264,7604,100,4595,60.4,4386,57.7,209,2.7,220,2.9,168,2.2,52,0.7,2789,36.7
E02003265,6802,100,4151,61,3978,58.5,173,2.5,137,2,98,1.4,39,0.6,2514,37
E02003266,7539,100,4448,59,4152,55.1,296,3.9,252,3.3,190,2.5,62,0.8,2839,37.7
E02003267,10566,100,5680,53.8,5228,49.5,452,4.3,475,4.5,334,3.2,141,1.3,4411,41.7
E02003268,9323,100,5149,55.2,4788,51.4,361,3.9,417,4.5,300,3.2,117,1.3,3757,40.3
E02003269,8501,100,5371,63.2,5060,59.5,311,3.7,267,3.1,225,2.6,42,0.5,2863,33.7
E02003270,6946,100,4052,58.3,3837,55.2,215,3.1,190,2.7,144,2.1,46,0.7,2704,38.9
E02003271,8206,100,5559,67.7,5298,64.6,261,3.2,198,2.4,139,1.7,59,0.7,2449,29.8
E02003272,8216,100,4224,51.4,3882,47.2,342,4.2,313,3.8,230,2.8,83,1,3679,44.8
E02003273,9282,100,5779,62.3,5376,57.9,403,4.3,279,3,206,2.2,73,0.8,3224,34.7
E02003274,8359,100,4285,51.3,3823,45.7,462,5.5,391,4.7,274,3.3,117,1.4,3683,44.1
E02003276,6789,100,3761,55.4,3227,47.5,534,7.9,399,5.9,291,4.3,108,1.6,2629,38.7
E02003277,8689,100,4917,56.6,4487,51.6,430,4.9,377,4.3,280,3.2,97,1.1,3395,39.1
E02003278,10563,100,6519,61.7,5949,56.3,570,5.4,844,8,655,6.2,189,1.8,3200,30.3
E02006937,7445,100,4796,64.4,4417,59.3,379,5.1,478,6.4,385,5.2,93,1.2,2171,29.2
E02006938,5314,100,2781,52.3,2402,45.2,379,7.1,650,12.2,447,8.4,203,3.8,1883,35.4
E02003279,7933,100,4412,55.6,4243,53.5,169,2.1,98,1.2,77,1,21,0.3,3423,43.1
E02003280,8565,100,4953,57.8,4721,55.1,232,2.7,107,1.2,91,1.1,16,0.2,3505,40.9
E02003281,7914,100,4160,52.6,3979,50.3,181,2.3,91,1.1,75,0.9,16,0.2,3663,46.3
E02003282,8585,100,4990,58.1,4764,55.5,226,2.6,130,1.5,95,1.1,35,0.4,3465,40.4
E02003283,8775,100,5074,57.8,4833,55.1,241,2.7,141,1.6,96,1.1,45,0.5,3560,40.6
E02003284,8864,100,5592,63.1,5266,59.4,326,3.7,170,1.9,139,1.6,31,0.3,3102,35
E02003285,8767,100,5892,67.2,5530,63.1,362,4.1,130,1.5,91,1,39,0.4,2745,31.3
E02003286,7535,100,4569,60.6,4417,58.6,152,2,112,1.5,78,1,34,0.5,2854,37.9
E02003287,8147,100,4186,51.4,3899,47.9,287,3.5,118,1.4,88,1.1,30,0.4,3843,47.2
E02003288,10260,100,6306,61.5,5884,57.3,422,4.1,231,2.3,184,1.8,47,0.5,3723,36.3
E02003289,8153,100,5460,67,5240,64.3,220,2.7,116,1.4,90,1.1,26,0.3,2577,31.6
E02003290,8314,100,4901,58.9,4674,56.2,227,2.7,115,1.4,87,1,28,0.3,3298,39.7
E02003291,9442,100,5538,58.7,5234,55.4,304,3.2,143,1.5,100,1.1,43,0.5,3761,39.8
E02003292,9543,100,5800,60.8,5302,55.6,498,5.2,186,1.9,129,1.4,57,0.6,3557,37.3
E02003293,9820,100,5894,60,5415,55.1,479,4.9,236,2.4,162,1.6,74,0.8,3690,37.6
E02003294,7699,100,4032,52.4,3865,50.2,167,2.2,105,1.4,67,0.9,38,0.5,3562,46.3
E02003295,8088,100,4504,55.7,4243,52.5,261,3.2,140,1.7,93,1.1,47,0.6,3444,42.6
E02003296,5919,100,3470,58.6,3340,56.4,130,2.2,101,1.7,73,1.2,28,0.5,2348,39.7
E02003297,5889,100,3299,56,3158,53.6,141,2.4,113,1.9,80,1.4,33,0.6,2477,42.1
E02003298,5815,100,3398,58.4,3265,56.1,133,2.3,79,1.4,57,1,22,0.4,2338,40.2
E02003299,5377,100,3305,61.5,3178,59.1,127,2.4,84,1.6,59,1.1,25,0.5,1988,37
E02003300,7104,100,4627,65.1,4449,62.6,178,2.5,153,2.2,118,1.7,35,0.5,2324,32.7
E02003301,9201,100,6063,65.9,5729,62.3,334,3.6,209,2.3,161,1.7,48,0.5,2929,31.8
E02003302,7939,100,5006,63.1,4698,59.2,308,3.9,204,2.6,157,2,47,0.6,2729,34.4
E02003303,7328,100,4782,65.3,4551,62.1,231,3.2,177,2.4,130,1.8,47,0.6,2369,32.3
E02003304,7673,100,4472,58.3,4267,55.6,205,2.7,161,2.1,122,1.6,39,0.5,3040,39.6
E02003305,5579,100,3367,60.4,3228,57.9,139,2.5,106,1.9,83,1.5,23,0.4,2106,37.7
E02003307,8137,100,4685,57.6,4405,54.1,280,3.4,159,2,114,1.4,45,0.6,3293,40.5
E02003308,5853,100,3943,67.4,3765,64.3,178,3,130,2.2,98,1.7,32,0.5,1780,30.4
E02003309,6329,100,3934,62.2,3799,60,135,2.1,148,2.3,114,1.8,34,0.5,2247,35.5
E02003311,7415,100,4891,66,4634,62.5,257,3.5,219,3,184,2.5,35,0.5,2305,31.1
E02003312,6935,100,4924,71,4584,66.1,340,4.9,238,3.4,197,2.8,41,0.6,1773,25.6
E02003313,10701,100,6597,61.6,6121,57.2,476,4.4,362,3.4,266,2.5,96,0.9,3742,35
E02006859,5730,100,4353,76,4158,72.6,195,3.4,173,3,141,2.5,32,0.6,1204,21
E02006926,6184,100,4476,72.4,4301,69.6,175,2.8,162,2.6,122,2,40,0.6,1546,25
E02007004,4956,100,3565,71.9,3352,67.6,213,4.3,159,3.2,131,2.6,28,0.6,1232,24.9
E02007005,6301,100,4601,73,4379,69.5,222,3.5,222,3.5,186,3,36,0.6,1478,23.5
E02003616,4741,100,2740,57.8,2663,56.2,77,1.6,91,1.9,60,1.3,31,0.7,1910,40.3
E02003617,7531,100,4351,57.8,4210,55.9,141,1.9,87,1.2,54,0.7,33,0.4,3093,41.1
E02003618,7058,100,4260,60.4,4147,58.8,113,1.6,155,2.2,111,1.6,44,0.6,2643,37.4
E02003619,9580,100,5988,62.5,5796,60.5,192,2,179,1.9,127,1.3,52,0.5,3413,35.6
E02003620,6724,100,3794,56.4,3606,53.6,188,2.8,97,1.4,70,1,27,0.4,2833,42.1
E02003621,6728,100,3703,55,3581,53.2,122,1.8,135,2,111,1.6,24,0.4,2890,43
E02003622,7263,100,4347,59.9,4104,56.5,243,3.3,152,2.1,107,1.5,45,0.6,2764,38.1
E02003623,10079,100,6715,66.6,6504,64.5,211,2.1,189,1.9,149,1.5,40,0.4,3175,31.5
E02003624,5051,100,2744,54.3,2618,51.8,126,2.5,219,4.3,153,3,66,1.3,2088,41.3
E02003625,7577,100,4504,59.4,4191,55.3,313,4.1,168,2.2,135,1.8,33,0.4,2905,38.3
E02003626,4594,100,2979,64.8,2868,62.4,111,2.4,93,2,83,1.8,10,0.2,1522,33.1
E02003627,8912,100,5850,65.6,5458,61.2,392,4.4,249,2.8,205,2.3,44,0.5,2813,31.6
E02003628,7147,100,4231,59.2,3933,55,298,4.2,194,2.7,156,2.2,38,0.5,2722,38.1
E02003629,8327,100,5218,62.7,4919,59.1,299,3.6,199,2.4,142,1.7,57,0.7,2910,34.9
E02003630,8896,100,5796,65.2,5424,61,372,4.2,251,2.8,202,2.3,49,0.6,2849,32
E02003631,4559,100,2763,60.6,2612,57.3,151,3.3,107,2.3,87,1.9,20,0.4,1689,37
E02003632,5006,100,3235,64.6,3095,61.8,140,2.8,98,2,83,1.7,15,0.3,1673,33.4
E02003633,8274,100,5542,67,5300,64.1,242,2.9,184,2.2,130,1.6,54,0.7,2548,30.8
E02003635,7768,100,5375,69.2,5214,67.1,161,2.1,134,1.7,96,1.2,38,0.5,2259,29.1
E02007010,6713,100,4510,67.2,4360,64.9,150,2.2,124,1.8,92,1.4,32,0.5,2079,31
E02007011,5577,100,3930,70.5,3808,68.3,122,2.2,121,2.2,96,1.7,25,0.4,1526,27.4
E02003599,4548,100,2965,65.2,2853,62.7,112,2.5,91,2,68,1.5,23,0.5,1492,32.8
E02003600,5275,100,3248,61.6,3139,59.5,109,2.1,97,1.8,66,1.3,31,0.6,1930,36.6
E02003601,6674,100,4235,63.5,4121,61.7,114,1.7,87,1.3,65,1,22,0.3,2352,35.2
E02003602,5517,100,3295,59.7,3221,58.4,74,1.3,87,1.6,69,1.3,18,0.3,2135,38.7
E02003603,9122,100,6186,67.8,5954,65.3,232,2.5,119,1.3,90,1,29,0.3,2817,30.9
E02003604,8862,100,6126,69.1,5951,67.2,175,2,147,1.7,123,1.4,24,0.3,2589,29.2
E02003605,8333,100,4868,58.4,4719,56.6,149,1.8,343,4.1,195,2.3,148,1.8,3122,37.5
E02003606,7665,100,4728,61.7,4572,59.6,156,2,142,1.9,98,1.3,44,0.6,2795,36.5
E02003607,8824,100,6014,68.2,5830,66.1,184,2.1,125,1.4,82,0.9,43,0.5,2685,30.4
E02003608,9876,100,6610,66.9,6392,64.7,218,2.2,133,1.3,104,1.1,29,0.3,3133,31.7
E02003609,9398,100,6362,67.7,6184,65.8,178,1.9,173,1.8,138,1.5,35,0.4,2863,30.5
E02003610,7193,100,4691,65.2,4559,63.4,132,1.8,153,2.1,117,1.6,36,0.5,2349,32.7
E02003611,7943,100,5124,64.5,4980,62.7,144,1.8,143,1.8,119,1.5,24,0.3,2676,33.7
E02003612,9571,100,6569,68.6,6370,66.6,199,2.1,184,1.9,140,1.5,44,0.5,2818,29.4
E02003613,4732,100,2977,62.9,2878,60.8,99,2.1,87,1.8,60,1.3,27,0.6,1668,35.2
E02003614,6656,100,4562,68.5,4432,66.6,130,2,113,1.7,84,1.3,29,0.4,1981,29.8
E02003615,8462,100,5270,62.3,5128,60.6,142,1.7,144,1.7,112,1.3,32,0.4,3048,36
E02003636,6044,100,3750,62,3641,60.2,109,1.8,116,1.9,85,1.4,31,0.5,2178,36
E02003637,8843,100,5687,64.3,5516,62.4,171,1.9,114,1.3,83,0.9,31,0.4,3042,34.4
E02003638,6265,100,3802,60.7,3645,58.2,157,2.5,72,1.1,47,0.8,25,0.4,2391,38.2
E02003639,7719,100,5009,64.9,4804,62.2,205,2.7,79,1,67,0.9,12,0.2,2631,34.1
E02003640,5041,100,3132,62.1,3032,60.1,100,2,60,1.2,39,0.8,21,0.4,1849,36.7
E02003641,4361,100,2756,63.2,2690,61.7,66,1.5,89,2,76,1.7,13,0.3,1516,34.8
E02003642,7276,100,4660,64,4393,60.4,267,3.7,193,2.7,137,1.9,56,0.8,2423,33.3
E02003643,10399,100,7493,72.1,7266,69.9,227,2.2,141,1.4,106,1,35,0.3,2765,26.6
E02003644,7953,100,5247,66,5015,63.1,232,2.9,165,2.1,135,1.7,30,0.4,2541,32
E02003645,5700,100,3601,63.2,3466,60.8,135,2.4,131,2.3,98,1.7,33,0.6,1968,34.5
E02003646,8299,100,5423,65.3,5199,62.6,224,2.7,191,2.3,156,1.9,35,0.4,2685,32.4
E02003647,8572,100,5672,66.2,5439,63.5,233,2.7,222,2.6,192,2.2,30,0.3,2678,31.2
E02003648,4336,100,2690,62,2542,58.6,148,3.4,103,2.4,79,1.8,24,0.6,1543,35.6
E02003649,5549,100,3400,61.3,3289,59.3,111,2,124,2.2,101,1.8,23,0.4,2025,36.5
E02003650,5926,100,3319,56,3199,54,120,2,64,1.1,45,0.8,19,0.3,2543,42.9
E02003651,5821,100,3514,60.4,3423,58.8,91,1.6,75,1.3,60,1,15,0.3,2232,38.3
E02003719,8473,100,5716,67.5,5457,64.4,259,3.1,228,2.7,184,2.2,44,0.5,2529,29.8
E02003720,7961,100,4850,60.9,4609,57.9,241,3,244,3.1,215,2.7,29,0.4,2867,36
E02003721,8094,100,5122,63.3,4888,60.4,234,2.9,228,2.8,184,2.3,44,0.5,2744,33.9
E02003722,7286,100,4546,62.4,4394,60.3,152,2.1,286,3.9,240,3.3,46,0.6,2454,33.7
E02003723,12070,100,3607,29.9,3493,28.9,114,0.9,873,7.2,722,6,151,1.3,7590,62.9
E02003724,8554,100,5411,63.3,5203,60.8,208,2.4,383,4.5,310,3.6,73,0.9,2760,32.3
E02003725,15196,100,3824,25.2,3712,24.4,112,0.7,1266,8.3,1058,7,208,1.4,10106,66.5
E02003726,7289,100,4096,56.2,3953,54.2,143,2,541,7.4,397,5.4,144,2,2652,36.4
E02003727,8899,100,5856,65.8,5688,63.9,168,1.9,618,6.9,489,5.5,129,1.4,2425,27.3
E02003728,9427,100,5957,63.2,5776,61.3,181,1.9,525,5.6,453,4.8,72,0.8,2945,31.2
E02003729,7475,100,4861,65,4712,63,149,2,142,1.9,123,1.6,19,0.3,2472,33.1
E02003731,10314,100,5353,51.9,5184,50.3,169,1.6,424,4.1,375,3.6,49,0.5,4537,44
E02007086,8238,100,5996,72.8,5785,70.2,211,2.6,196,2.4,167,2,29,0.4,2046,24.8
E02007087,5499,100,2584,47,2501,45.5,83,1.5,492,8.9,337,6.1,155,2.8,2423,44.1
E02003732,7933,100,5213,65.7,5046,63.6,167,2.1,79,1,58,0.7,21,0.3,2641,33.3
E02003733,6949,100,4384,63.1,4280,61.6,104,1.5,97,1.4,74,1.1,23,0.3,2468,35.5
E02003734,9698,100,6172,63.6,5922,61.1,250,2.6,145,1.5,108,1.1,37,0.4,3381,34.9
E02003735,7059,100,4527,64.1,4397,62.3,130,1.8,106,1.5,83,1.2,23,0.3,2426,34.4
E02003736,8438,100,5212,61.8,5059,60,153,1.8,103,1.2,79,0.9,24,0.3,3123,37
E02003737,10541,100,6997,66.4,6801,64.5,196,1.9,153,1.5,125,1.2,28,0.3,3391,32.2
E02003738,5202,100,3311,63.6,3239,62.3,72,1.4,74,1.4,67,1.3,7,0.1,1817,34.9
E02003739,5267,100,3236,61.4,3145,59.7,91,1.7,70,1.3,54,1,16,0.3,1961,37.2
E02003740,5156,100,3033,58.8,2949,57.2,84,1.6,87,1.7,67,1.3,20,0.4,2036,39.5
E02006825,5188,100,3153,60.8,3091,59.6,62,1.2,63,1.2,50,1,13,0.3,1972,38
E02003742,5794,100,2978,51.4,2872,49.6,106,1.8,65,1.1,49,0.8,16,0.3,2751,47.5
E02003743,8916,100,5235,58.7,4947,55.5,288,3.2,115,1.3,95,1.1,20,0.2,3566,40
E02003744,11415,100,6701,58.7,6353,55.7,348,3,125,1.1,98,0.9,27,0.2,4589,40.2
E02003745,8628,100,4747,55,4550,52.7,197,2.3,107,1.2,77,0.9,30,0.3,3774,43.7
E02003746,6445,100,3631,56.3,3453,53.6,178,2.8,102,1.6,81,1.3,21,0.3,2712,42.1
E02003747,10434,100,6034,57.8,5788,55.5,246,2.4,153,1.5,113,1.1,40,0.4,4247,40.7
E02003748,6328,100,3393,53.6,3249,51.3,144,2.3,51,0.8,31,0.5,20,0.3,2884,45.6
E02003749,5113,100,3069,60,2972,58.1,97,1.9,71,1.4,54,1.1,17,0.3,1973,38.6
E02003750,6319,100,3363,53.2,3223,51,140,2.2,58,0.9,42,0.7,16,0.3,2898,45.9
E02003751,6244,100,3581,57.4,3470,55.6,111,1.8,85,1.4,64,1,21,0.3,2578,41.3
E02003752,9211,100,5621,61,5447,59.1,174,1.9,111,1.2,84,0.9,27,0.3,3479,37.8
E02003753,9003,100,5681,63.1,5474,60.8,207,2.3,151,1.7,126,1.4,25,0.3,3171,35.2
E02003754,4751,100,2852,60,2774,58.4,78,1.6,74,1.6,56,1.2,18,0.4,1825,38.4
E02003755,7082,100,4356,61.5,4221,59.6,135,1.9,93,1.3,71,1,22,0.3,2633,37.2
E02003756,5873,100,3719,63.3,3590,61.1,129,2.2,87,1.5,61,1,26,0.4,2067,35.2
E02003757,5712,100,3466,60.7,3377,59.1,89,1.6,67,1.2,51,0.9,16,0.3,2179,38.1
E02003758,7982,100,5112,64,4960,62.1,152,1.9,111,1.4,86,1.1,25,0.3,2759,34.6
E02003759,4977,100,3008,60.4,2926,58.8,82,1.6,72,1.4,47,0.9,25,0.5,1897,38.1
E02003760,6941,100,4610,66.4,4391,63.3,219,3.2,183,2.6,147,2.1,36,0.5,2148,30.9
E02003761,5055,100,2947,58.3,2873,56.8,74,1.5,85,1.7,60,1.2,25,0.5,2023,40
E02003762,9138,100,5844,64,5669,62,175,1.9,171,1.9,141,1.5,30,0.3,3123,34.2
E02003763,7880,100,5124,65,4961,63,163,2.1,121,1.5,96,1.2,25,0.3,2635,33.4
E02003764,8509,100,5985,70.3,5774,67.9,211,2.5,149,1.8,119,1.4,30,0.4,2375,27.9
E02003765,6044,100,3568,59,3442,56.9,126,2.1,92,1.5,66,1.1,26,0.4,2384,39.4
E02003766,6287,100,4175,66.4,4040,64.3,135,2.1,110,1.7,95,1.5,15,0.2,2002,31.8
E02003767,5403,100,3245,60.1,3171,58.7,74,1.4,78,1.4,59,1.1,19,0.4,2080,38.5
E02003768,8325,100,4845,58.2,4736,56.9,109,1.3,103,1.2,86,1,17,0.2,3377,40.6
E02003769,6480,100,3184,49.1,3078,47.5,106,1.6,79,1.2,63,1,16,0.2,3217,49.6
E02003770,8448,100,5545,65.6,5378,63.7,167,2,153,1.8,113,1.3,40,0.5,2750,32.6
E02003771,5289,100,3245,61.4,3123,59,122,2.3,74,1.4,63,1.2,11,0.2,1970,37.2
E02003772,5686,100,3358,59.1,3257,57.3,101,1.8,103,1.8,88,1.5,15,0.3,2225,39.1
E02003773,8651,100,5783,66.8,5560,64.3,223,2.6,121,1.4,100,1.2,21,0.2,2747,31.8
E02003774,4750,100,2872,60.5,2778,58.5,94,2,50,1.1,44,0.9,6,0.1,1828,38.5
E02003775,5855,100,3708,63.3,3602,61.5,106,1.8,95,1.6,75,1.3,20,0.3,2052,35
E02003776,5571,100,3425,61.5,3361,60.3,64,1.1,73,1.3,56,1,17,0.3,2073,37.2
E02003777,7714,100,5317,68.9,5164,66.9,153,2,120,1.6,87,1.1,33,0.4,2277,29.5
E02003778,5285,100,3535,66.9,3452,65.3,83,1.6,77,1.5,65,1.2,12,0.2,1673,31.7
E02003780,9236,100,5956,64.5,5758,62.3,198,2.1,177,1.9,150,1.6,27,0.3,3103,33.6
E02003781,5137,100,3419,66.6,3322,64.7,97,1.9,69,1.3,60,1.2,9,0.2,1649,32.1
E02003784,7270,100,4524,62.2,4397,60.5,127,1.7,133,1.8,111,1.5,22,0.3,2613,35.9
E02003785,7256,100,4700,64.8,4536,62.5,164,2.3,97,1.3,72,1,25,0.3,2459,33.9
E02003786,5364,100,3179,59.3,3095,57.7,84,1.6,50,0.9,37,0.7,13,0.2,2135,39.8
E02003787,6343,100,3795,59.8,3610,56.9,185,2.9,71,1.1,56,0.9,15,0.2,2477,39.1
E02003788,6444,100,4127,64,4018,62.4,109,1.7,103,1.6,86,1.3,17,0.3,2214,34.4
E02003789,5851,100,3529,60.3,3403,58.2,126,2.2,71,1.2,55,0.9,16,0.3,2251,38.5
E02003790,7745,100,4631,59.8,4519,58.3,112,1.4,118,1.5,97,1.3,21,0.3,2996,38.7
E02003791,6675,100,4247,63.6,4151,62.2,96,1.4,91,1.4,75,1.1,16,0.2,2337,35
E02003792,8024,100,4822,60.1,4706,58.6,116,1.4,99,1.2,76,0.9,23,0.3,3103,38.7
E02003793,5871,100,3613,61.5,3537,60.2,76,1.3,96,1.6,73,1.2,23,0.4,2162,36.8
E02006873,6959,100,5207,74.8,5047,72.5,160,2.3,203,2.9,152,2.2,51,0.7,1549,22.3
E02006874,7985,100,5446,68.2,5315,66.6,131,1.6,146,1.8,118,1.5,28,0.4,2393,30
E02007085,9786,100,5855,59.8,5670,57.9,185,1.9,129,1.3,102,1,27,0.3,3802,38.9
E02004424,5701,100,3430,60.2,3341,58.6,89,1.6,96,1.7,64,1.1,32,0.6,2175,38.2
E02004425,5940,100,3701,62.3,3571,60.1,130,2.2,81,1.4,59,1,22,0.4,2158,36.3
E02004426,6586,100,3986,60.5,3831,58.2,155,2.4,88,1.3,71,1.1,17,0.3,2512,38.1
E02004427,6593,100,3749,56.9,3641,55.2,108,1.6,76,1.2,56,0.8,20,0.3,2768,42
E02004428,5749,100,3413,59.4,3275,57,138,2.4,54,0.9,36,0.6,18,0.3,2282,39.7
E02004429,6403,100,3492,54.5,3358,52.4,134,2.1,111,1.7,90,1.4,21,0.3,2800,43.7
E02004430,6768,100,4358,64.4,4220,62.4,138,2,107,1.6,76,1.1,31,0.5,2303,34
E02004431,7734,100,5206,67.3,5021,64.9,185,2.4,145,1.9,110,1.4,35,0.5,2383,30.8
E02004432,5333,100,3192,59.9,3074,57.6,118,2.2,71,1.3,52,1,19,0.4,2070,38.8
E02004433,7069,100,4408,62.4,4216,59.6,192,2.7,95,1.3,73,1,22,0.3,2566,36.3
E02004434,6861,100,4329,63.1,4127,60.2,202,2.9,111,1.6,93,1.4,18,0.3,2421,35.3
E02004435,7457,100,4848,65,4612,61.8,236,3.2,148,2,123,1.6,25,0.3,2461,33
E02004436,5956,100,3244,54.5,2999,50.4,245,4.1,128,2.1,96,1.6,32,0.5,2584,43.4
E02004437,7951,100,4905,61.7,4698,59.1,207,2.6,123,1.5,96,1.2,27,0.3,2923,36.8
E02004438,7375,100,4467,60.6,4171,56.6,296,4,166,2.3,134,1.8,32,0.4,2742,37.2
E02004439,7152,100,4463,62.4,4147,58,316,4.4,183,2.6,146,2,37,0.5,2506,35
E02004440,7093,100,4645,65.5,4375,61.7,270,3.8,132,1.9,106,1.5,26,0.4,2316,32.7
E02004441,6229,100,3531,56.7,3327,53.4,204,3.3,105,1.7,79,1.3,26,0.4,2593,41.6
E02004442,6410,100,3815,59.5,3488,54.4,327,5.1,129,2,95,1.5,34,0.5,2466,38.5
E02004443,8364,100,5532,66.1,5259,62.9,273,3.3,139,1.7,105,1.3,34,0.4,2693,32.2
E02004444,7367,100,4692,63.7,4512,61.2,180,2.4,144,2,118,1.6,26,0.4,2531,34.4
E02004445,6576,100,3980,60.5,3745,56.9,235,3.6,142,2.2,110,1.7,32,0.5,2454,37.3
E02004446,5880,100,3513,59.7,3399,57.8,114,1.9,92,1.6,70,1.2,22,0.4,2275,38.7
E02004447,5152,100,2949,57.2,2852,55.4,97,1.9,68,1.3,47,0.9,21,0.4,2135,41.4
E02004448,6400,100,3944,61.6,3817,59.6,127,2,78,1.2,54,0.8,24,0.4,2378,37.2
E02004449,7171,100,4371,61,4140,57.7,231,3.2,109,1.5,88,1.2,21,0.3,2691,37.5
E02004450,5364,100,3157,58.9,3084,57.5,73,1.4,50,0.9,26,0.5,24,0.4,2157,40.2
E02004451,7836,100,4635,59.2,4513,57.6,122,1.6,142,1.8,113,1.4,29,0.4,3059,39
E02004452,7621,100,4539,59.6,4400,57.7,139,1.8,114,1.5,85,1.1,29,0.4,2968,38.9
E02004453,5872,100,3491,59.5,3307,56.3,184,3.1,104,1.8,75,1.3,29,0.5,2277,38.8
E02004454,7805,100,5087,65.2,4862,62.3,225,2.9,125,1.6,98,1.3,27,0.3,2593,33.2
E02004455,6469,100,4080,63.1,3950,61.1,130,2,140,2.2,116,1.8,24,0.4,2249,34.8
E02004456,7840,100,5069,64.7,4777,60.9,292,3.7,132,1.7,76,1,56,0.7,2639,33.7
E02004457,8438,100,5370,63.6,5132,60.8,238,2.8,152,1.8,110,1.3,42,0.5,2916,34.6
E02004458,7583,100,4846,63.9,4693,61.9,153,2,153,2,122,1.6,31,0.4,2584,34.1
E02004459,8631,100,4928,57.1,4766,55.2,162,1.9,160,1.9,119,1.4,41,0.5,3543,41
E02004460,7880,100,4835,61.4,4642,58.9,193,2.4,106,1.3,71,0.9,35,0.4,2939,37.3
E02004461,4457,100,2887,64.8,2724,61.1,163,3.7,81,1.8,64,1.4,17,0.4,1489,33.4
E02004462,9454,100,6113,64.7,5846,61.8,267,2.8,148,1.6,107,1.1,41,0.4,3193,33.8
E02004463,6717,100,3992,59.4,3875,57.7,117,1.7,80,1.2,64,1,16,0.2,2645,39.4
E02004464,8236,100,4673,56.7,4522,54.9,151,1.8,109,1.3,91,1.1,18,0.2,3454,41.9
E02004465,5287,100,3043,57.6,2959,56,84,1.6,59,1.1,49,0.9,10,0.2,2185,41.3
E02004466,6579,100,4034,61.3,3873,58.9,161,2.4,84,1.3,71,1.1,13,0.2,2461,37.4
E02004467,6481,100,4101,63.3,3950,60.9,151,2.3,111,1.7,80,1.2,31,0.5,2269,35
E02004468,8624,100,4878,56.6,4713,54.6,165,1.9,103,1.2,75,0.9,28,0.3,3643,42.2
E02004469,5833,100,3710,63.6,3569,61.2,141,2.4,57,1,45,0.8,12,0.2,2066,35.4
E02004470,9768,100,6769,69.3,6461,66.1,308,3.2,140,1.4,105,1.1,35,0.4,2859,29.3
E02004471,6922,100,4279,61.8,4107,59.3,172,2.5,92,1.3,72,1,20,0.3,2551,36.9
E02004472,5148,100,3205,62.3,3117,60.5,88,1.7,64,1.2,46,0.9,18,0.3,1879,36.5
E02004473,6348,100,3795,59.8,3667,57.8,128,2,101,1.6,88,1.4,13,0.2,2452,38.6
E02004474,6672,100,3823,57.3,3695,55.4,128,1.9,81,1.2,69,1,12,0.2,2768,41.5
E02004475,5487,100,3143,57.3,3053,55.6,90,1.6,103,1.9,75,1.4,28,0.5,2241,40.8
E02004476,6737,100,3972,59,3848,57.1,124,1.8,135,2,107,1.6,28,0.4,2630,39
E02004477,5158,100,2748,53.3,2653,51.4,95,1.8,49,0.9,34,0.7,15,0.3,2361,45.8
E02004478,5583,100,3138,56.2,3003,53.8,135,2.4,97,1.7,80,1.4,17,0.3,2348,42.1
E02004479,6718,100,3977,59.2,3835,57.1,142,2.1,99,1.5,75,1.1,24,0.4,2642,39.3
E02004480,5536,100,3426,61.9,3297,59.6,129,2.3,95,1.7,73,1.3,22,0.4,2015,36.4
E02004481,5779,100,2732,47.3,2596,44.9,136,2.4,64,1.1,45,0.8,19,0.3,2983,51.6
E02004482,6588,100,3770,57.2,3584,54.4,186,2.8,98,1.5,75,1.1,23,0.3,2720,41.3
E02004483,6751,100,3511,52,3348,49.6,163,2.4,89,1.3,54,0.8,35,0.5,3151,46.7
E02004484,7056,100,3776,53.5,3596,51,180,2.6,86,1.2,55,0.8,31,0.4,3194,45.3
E02004485,7602,100,4851,63.8,4682,61.6,169,2.2,120,1.6,111,1.5,9,0.1,2631,34.6
E02004486,7072,100,4221,59.7,4115,58.2,106,1.5,131,1.9,98,1.4,33,0.5,2720,38.5
E02004487,5993,100,3549,59.2,3394,56.6,155,2.6,104,1.7,73,1.2,31,0.5,2340,39
E02004488,7923,100,5161,65.1,4993,63,168,2.1,168,2.1,124,1.6,44,0.6,2594,32.7
E02004489,7457,100,4734,63.5,4561,61.2,173,2.3,143,1.9,104,1.4,39,0.5,2580,34.6
E02004490,6193,100,3665,59.2,3463,55.9,202,3.3,158,2.6,121,2,37,0.6,2370,38.3
E02004491,6029,100,3866,64.1,3751,62.2,115,1.9,107,1.8,88,1.5,19,0.3,2056,34.1
E02004492,7576,100,5283,69.7,5090,67.2,193,2.5,138,1.8,91,1.2,47,0.6,2155,28.4
E02004493,8366,100,5576,66.7,5370,64.2,206,2.5,190,2.3,140,1.7,50,0.6,2600,31.1
E02004495,7012,100,3771,53.8,3636,51.9,135,1.9,158,2.3,124,1.8,34,0.5,3083,44
E02004496,6533,100,4257,65.2,4112,62.9,145,2.2,101,1.5,76,1.2,25,0.4,2175,33.3
E02004497,6563,100,3705,56.5,3596,54.8,109,1.7,115,1.8,102,1.6,13,0.2,2743,41.8
E02004498,7974,100,4775,59.9,4571,57.3,204,2.6,141,1.8,119,1.5,22,0.3,3058,38.3
E02004499,5558,100,3556,64,3435,61.8,121,2.2,122,2.2,99,1.8,23,0.4,1880,33.8
E02004500,7613,100,4210,55.3,4073,53.5,137,1.8,112,1.5,89,1.2,23,0.3,3291,43.2
E02004501,5763,100,3316,57.5,3184,55.2,132,2.3,83,1.4,65,1.1,18,0.3,2364,41
E02004502,6182,100,3176,51.4,3067,49.6,109,1.8,63,1,49,0.8,14,0.2,2943,47.6
E02004503,6487,100,4078,62.9,3940,60.7,138,2.1,102,1.6,74,1.1,28,0.4,2307,35.6
E02004504,6575,100,4164,63.3,4033,61.3,131,2,111,1.7,96,1.5,15,0.2,2300,35
E02004505,5448,100,3055,56.1,2956,54.3,99,1.8,78,1.4,58,1.1,20,0.4,2315,42.5
E02006978,6321,100,3981,63,3784,59.9,197,3.1,285,4.5,187,3,98,1.6,2055,32.5
E02006979,5495,100,4046,73.6,3866,70.4,180,3.3,118,2.1,102,1.9,16,0.3,1331,24.2
E02004506,5878,100,3421,58.2,3333,56.7,88,1.5,99,1.7,77,1.3,22,0.4,2358,40.1
E02004507,7626,100,5043,66.1,4818,63.2,225,3,198,2.6,147,1.9,51,0.7,2385,31.3
E02004508,5431,100,3140,57.8,3031,55.8,109,2,90,1.7,56,1,34,0.6,2201,40.5
E02004512,9484,100,6055,63.8,5717,60.3,338,3.6,282,3,224,2.4,58,0.6,3147,33.2
E02004513,9551,100,3669,38.4,3392,35.5,277,2.9,1152,12.1,681,7.1,471,4.9,4730,49.5
E02004514,4746,100,2729,57.5,2623,55.3,106,2.2,91,1.9,72,1.5,19,0.4,1926,40.6
E02004515,7756,100,4952,63.8,4806,62,146,1.9,152,2,110,1.4,42,0.5,2652,34.2
E02004516,10604,100,6604,62.3,6222,58.7,382,3.6,517,4.9,315,3,202,1.9,3483,32.8
E02004517,7747,100,4708,60.8,4578,59.1,130,1.7,185,2.4,147,1.9,38,0.5,2854,36.8
E02004518,6344,100,4249,67,4105,64.7,144,2.3,175,2.8,142,2.2,33,0.5,1920,30.3
E02004519,6249,100,3345,53.5,3238,51.8,107,1.7,139,2.2,85,1.4,54,0.9,2765,44.2
E02004520,7143,100,4823,67.5,4603,64.4,220,3.1,176,2.5,124,1.7,52,0.7,2144,30
E02004521,7666,100,4615,60.2,4410,57.5,205,2.7,228,3,177,2.3,51,0.7,2823,36.8
E02004522,7747,100,3533,45.6,3427,44.2,106,1.4,524,6.8,275,3.5,249,3.2,3690,47.6
E02004523,8122,100,5167,63.6,4890,60.2,277,3.4,178,2.2,143,1.8,35,0.4,2777,34.2
E02004524,6953,100,3974,57.2,3877,55.8,97,1.4,114,1.6,82,1.2,32,0.5,2865,41.2
E02004525,6812,100,3761,55.2,3641,53.4,120,1.8,121,1.8,93,1.4,28,0.4,2930,43
E02004526,6348,100,2979,46.9,2865,45.1,114,1.8,103,1.6,80,1.3,23,0.4,3266,51.4
E02006922,11708,100,6597,56.3,6282,53.7,315,2.7,279,2.4,203,1.7,76,0.6,4832,41.3
E02007056,6503,100,4761,73.2,4587,70.5,174,2.7,138,2.1,90,1.4,48,0.7,1604,24.7
E02007057,5937,100,4278,72.1,4128,69.5,150,2.5,157,2.6,122,2.1,35,0.6,1502,25.3
E02004527,7712,100,4792,62.1,4617,59.9,175,2.3,107,1.4,92,1.2,15,0.2,2813,36.5
E02004528,7445,100,4485,60.2,4331,58.2,154,2.1,83,1.1,65,0.9,18,0.2,2877,38.6
E02004529,6170,100,3652,59.2,3529,57.2,123,2,72,1.2,55,0.9,17,0.3,2446,39.6
E02004530,5651,100,3293,58.3,3165,56,128,2.3,53,0.9,37,0.7,16,0.3,2305,40.8
E02004531,5766,100,3473,60.2,3325,57.7,148,2.6,72,1.2,52,0.9,20,0.3,2221,38.5
E02004532,5310,100,3308,62.3,3164,59.6,144,2.7,64,1.2,50,0.9,14,0.3,1938,36.5
E02004533,6236,100,3677,59,3465,55.6,212,3.4,78,1.3,63,1,15,0.2,2481,39.8
E02004534,7191,100,4675,65,4432,61.6,243,3.4,126,1.8,88,1.2,38,0.5,2390,33.2
E02004535,5111,100,2969,58.1,2822,55.2,147,2.9,85,1.7,63,1.2,22,0.4,2057,40.2
E02004536,5195,100,2930,56.4,2794,53.8,136,2.6,42,0.8,28,0.5,14,0.3,2223,42.8
E02004537,7573,100,4788,63.2,4489,59.3,299,3.9,129,1.7,92,1.2,37,0.5,2656,35.1
E02004538,8069,100,5092,63.1,4869,60.3,223,2.8,98,1.2,75,0.9,23,0.3,2879,35.7
E02004539,6381,100,4076,63.9,3842,60.2,234,3.7,100,1.6,77,1.2,23,0.4,2205,34.6
E02004540,4895,100,3096,63.2,2979,60.9,117,2.4,62,1.3,45,0.9,17,0.3,1737,35.5
E02004541,9501,100,6246,65.7,5985,63,261,2.7,126,1.3,97,1,29,0.3,3129,32.9
E02004542,5723,100,3440,60.1,3318,58,122,2.1,79,1.4,68,1.2,11,0.2,2204,38.5
E02004543,5981,100,3695,61.8,3497,58.5,198,3.3,154,2.6,114,1.9,40,0.7,2132,35.6
E02004544,8791,100,6158,70,5944,67.6,214,2.4,147,1.7,98,1.1,49,0.6,2486,28.3
E02004545,6198,100,3821,61.6,3599,58.1,222,3.6,156,2.5,116,1.9,40,0.6,2221,35.8
E02004546,6655,100,4300,64.6,4016,60.3,284,4.3,145,2.2,123,1.8,22,0.3,2210,33.2
E02004547,7755,100,5096,65.7,4802,61.9,294,3.8,191,2.5,150,1.9,41,0.5,2468,31.8
E02004548,7038,100,4997,71,4826,68.6,171,2.4,163,2.3,133,1.9,30,0.4,1878,26.7
E02004549,6343,100,4044,63.8,3836,60.5,208,3.3,119,1.9,82,1.3,37,0.6,2180,34.4
E02004550,6872,100,4196,61.1,3935,57.3,261,3.8,165,2.4,128,1.9,37,0.5,2511,36.5
E02004551,5984,100,3664,61.2,3475,58.1,189,3.2,100,1.7,70,1.2,30,0.5,2220,37.1
E02004552,5375,100,3315,61.7,3138,58.4,177,3.3,108,2,81,1.5,27,0.5,1952,36.3
E02004553,6010,100,3874,64.5,3662,60.9,212,3.5,105,1.7,80,1.3,25,0.4,2031,33.8
E02004554,6077,100,3809,62.7,3590,59.1,219,3.6,148,2.4,92,1.5,56,0.9,2120,34.9
E02004555,5481,100,3212,58.6,3118,56.9,94,1.7,67,1.2,58,1.1,9,0.2,2202,40.2
E02004556,6304,100,3371,53.5,3293,52.2,78,1.2,100,1.6,73,1.2,27,0.4,2833,44.9
E02004557,7280,100,4464,61.3,4295,59,169,2.3,102,1.4,74,1,28,0.4,2714,37.3
E02004558,5817,100,3194,54.9,3045,52.3,149,2.6,57,1,44,0.8,13,0.2,2566,44.1
E02004559,6768,100,3927,58,3773,55.7,154,2.3,106,1.6,83,1.2,23,0.3,2735,40.4
E02004560,7524,100,4407,58.6,4212,56,195,2.6,59,0.8,48,0.6,11,0.1,3058,40.6
E02004561,8846,100,5112,57.8,4959,56.1,153,1.7,128,1.4,98,1.1,30,0.3,3606,40.8
E02004562,7402,100,4185,56.5,4006,54.1,179,2.4,84,1.1,70,0.9,14,0.2,3133,42.3
E02004563,5694,100,2951,51.8,2831,49.7,120,2.1,57,1,44,0.8,13,0.2,2686,47.2
E02004564,6646,100,3863,58.1,3746,56.4,117,1.8,88,1.3,69,1,19,0.3,2695,40.6
E02004566,4544,100,2693,59.3,2531,55.7,162,3.6,78,1.7,59,1.3,19,0.4,1773,39
E02004567,6810,100,3958,58.1,3829,56.2,129,1.9,98,1.4,79,1.2,19,0.3,2754,40.4
E02004568,7070,100,4656,65.9,4472,63.3,184,2.6,124,1.8,79,1.1,45,0.6,2290,32.4
E02004569,7029,100,4448,63.3,4272,60.8,176,2.5,103,1.5,78,1.1,25,0.4,2478,35.3
E02004570,7138,100,3962,55.5,3795,53.2,167,2.3,108,1.5,88,1.2,20,0.3,3068,43
E02004571,6438,100,3617,56.2,3513,54.6,104,1.6,81,1.3,66,1,15,0.2,2740,42.6
E02004572,6523,100,3875,59.4,3706,56.8,169,2.6,96,1.5,59,0.9,37,0.6,2552,39.1
E02006980,6244,100,3617,57.9,3510,56.2,107,1.7,110,1.8,84,1.3,26,0.4,2517,40.3
E02006981,6574,100,3811,58,3675,55.9,136,2.1,94,1.4,76,1.2,18,0.3,2669,40.6
E02004573,5238,100,2795,53.4,2586,49.4,209,4,67,1.3,34,0.6,33,0.6,2376,45.4
E02004574,6197,100,3345,54,3155,50.9,190,3.1,96,1.5,63,1,33,0.5,2756,44.5
E02004575,10127,100,5821,57.5,5680,56.1,141,1.4,142,1.4,107,1.1,35,0.3,4164,41.1
E02004576,7720,100,3992,51.7,3845,49.8,147,1.9,138,1.8,100,1.3,38,0.5,3590,46.5
E02004577,5061,100,3036,60,2951,58.3,85,1.7,91,1.8,70,1.4,21,0.4,1934,38.2
E02004578,6583,100,2571,39.1,2395,36.4,176,2.7,53,0.8,35,0.5,18,0.3,3959,60.1
E02004579,6763,100,3469,51.3,3328,49.2,141,2.1,88,1.3,60,0.9,28,0.4,3206,47.4
E02004580,10768,100,4461,41.4,4214,39.1,247,2.3,111,1,71,0.7,40,0.4,6196,57.5
E02004581,7135,100,3963,55.5,3831,53.7,132,1.9,106,1.5,82,1.1,24,0.3,3066,43
E02004582,6080,100,2640,43.4,2461,40.5,179,2.9,60,1,46,0.8,14,0.2,3380,55.6
E02004583,7497,100,3954,52.7,3777,50.4,177,2.4,101,1.3,79,1.1,22,0.3,3442,45.9
E02004584,5974,100,2221,37.2,2103,35.2,118,2,41,0.7,31,0.5,10,0.2,3712,62.1
E02004585,7452,100,3816,51.2,3588,48.1,228,3.1,118,1.6,79,1.1,39,0.5,3518,47.2
E02004586,6903,100,3139,45.5,2911,42.2,228,3.3,68,1,53,0.8,15,0.2,3696,53.5
E02004587,6153,100,2961,48.1,2696,43.8,265,4.3,57,0.9,31,0.5,26,0.4,3135,51
E02004588,5845,100,2694,46.1,2424,41.5,270,4.6,69,1.2,51,0.9,18,0.3,3082,52.7
E02004589,6116,100,2977,48.7,2774,45.4,203,3.3,61,1,46,0.8,15,0.2,3078,50.3
E02004590,7271,100,2756,37.9,2480,34.1,276,3.8,47,0.6,36,0.5,11,0.2,4468,61.4
E02004591,6146,100,3881,63.1,3768,61.3,113,1.8,86,1.4,65,1.1,21,0.3,2179,35.5
E02004592,10602,100,6582,62.1,6374,60.1,208,2,147,1.4,119,1.1,28,0.3,3873,36.5
E02004593,7345,100,4446,60.5,4322,58.8,124,1.7,55,0.7,39,0.5,16,0.2,2844,38.7
E02004594,6769,100,4194,62,4056,59.9,138,2,84,1.2,62,0.9,22,0.3,2491,36.8
E02004595,11896,100,7748,65.1,7480,62.9,268,2.3,163,1.4,135,1.1,28,0.2,3985,33.5
E02004596,8267,100,5503,66.6,5282,63.9,221,2.7,117,1.4,101,1.2,16,0.2,2647,32
E02004597,7271,100,4675,64.3,4517,62.1,158,2.2,110,1.5,77,1.1,33,0.5,2486,34.2
E02004598,8864,100,5479,61.8,5333,60.2,146,1.6,139,1.6,104,1.2,35,0.4,3246,36.6
E02004599,6354,100,3966,62.4,3833,60.3,133,2.1,92,1.4,72,1.1,20,0.3,2296,36.1
E02004843,5869,100,3514,59.9,3387,57.7,127,2.2,115,2,77,1.3,38,0.6,2240,38.2
E02004844,5965,100,3891,65.2,3738,62.7,153,2.6,115,1.9,85,1.4,30,0.5,1959,32.8
E02004845,6454,100,4020,62.3,3843,59.5,177,2.7,117,1.8,80,1.2,37,0.6,2317,35.9
E02004846,5252,100,3112,59.3,3022,57.5,90,1.7,74,1.4,52,1,22,0.4,2066,39.3
E02004847,7991,100,5123,64.1,4859,60.8,264,3.3,172,2.2,134,1.7,38,0.5,2696,33.7
E02004848,6135,100,3897,63.5,3708,60.4,189,3.1,101,1.6,71,1.2,30,0.5,2137,34.8
E02004849,5647,100,3564,63.1,3435,60.8,129,2.3,82,1.5,69,1.2,13,0.2,2001,35.4
E02004850,6011,100,3819,63.5,3615,60.1,204,3.4,79,1.3,58,1,21,0.3,2113,35.2
E02004851,4753,100,2861,60.2,2738,57.6,123,2.6,83,1.7,63,1.3,20,0.4,1809,38.1
E02004852,6453,100,4035,62.5,3838,59.5,197,3.1,130,2,101,1.6,29,0.4,2288,35.5
E02004853,5553,100,3365,60.6,3206,57.7,159,2.9,82,1.5,59,1.1,23,0.4,2106,37.9
E02004854,6581,100,4073,61.9,3864,58.7,209,3.2,127,1.9,102,1.5,25,0.4,2381,36.2
E02004855,6769,100,4248,62.8,3962,58.5,286,4.2,167,2.5,136,2,31,0.5,2354,34.8
E02004856,4661,100,3033,65.1,2945,63.2,88,1.9,74,1.6,52,1.1,22,0.5,1554,33.3
E02004857,4923,100,3035,61.6,2939,59.7,96,2,70,1.4,46,0.9,24,0.5,1818,36.9
E02004858,4005,100,2560,63.9,2467,61.6,93,2.3,88,2.2,60,1.5,28,0.7,1357,33.9
E02004859,4321,100,2638,61.1,2559,59.2,79,1.8,67,1.6,56,1.3,11,0.3,1616,37.4
E02004860,4537,100,3061,67.5,2936,64.7,125,2.8,98,2.2,88,1.9,10,0.2,1378,30.4
E02004861,4573,100,2518,55.1,2441,53.4,77,1.7,58,1.3,42,0.9,16,0.3,1997,43.7
E02004862,6080,100,3750,61.7,3531,58.1,219,3.6,125,2.1,107,1.8,18,0.3,2205,36.3
E02004863,6084,100,3727,61.3,3543,58.2,184,3,100,1.6,81,1.3,19,0.3,2257,37.1
E02004864,5237,100,3251,62.1,3151,60.2,100,1.9,63,1.2,46,0.9,17,0.3,1923,36.7
E02004865,4474,100,2963,66.2,2835,63.4,128,2.9,95,2.1,76,1.7,19,0.4,1416,31.6
E02004866,5349,100,3473,64.9,3342,62.5,131,2.4,83,1.6,65,1.2,18,0.3,1793,33.5
E02004867,4986,100,3118,62.5,3015,60.5,103,2.1,73,1.5,54,1.1,19,0.4,1795,36
E02004868,5896,100,3861,65.5,3706,62.9,155,2.6,104,1.8,86,1.5,18,0.3,1931,32.8
E02004869,4625,100,3070,66.4,2962,64,108,2.3,51,1.1,35,0.8,16,0.3,1504,32.5
E02004870,9271,100,6127,66.1,5820,62.8,307,3.3,221,2.4,187,2,34,0.4,2923,31.5
E02004871,4013,100,2612,65.1,2502,62.3,110,2.7,72,1.8,51,1.3,21,0.5,1329,33.1
E02004872,5972,100,3556,59.5,3425,57.4,131,2.2,121,2,97,1.6,24,0.4,2295,38.4
E02004873,9474,100,6583,69.5,6372,67.3,211,2.2,149,1.6,122,1.3,27,0.3,2742,28.9
E02004874,4846,100,3180,65.6,3033,62.6,147,3,101,2.1,78,1.6,23,0.5,1565,32.3
E02004875,8127,100,5407,66.5,5178,63.7,229,2.8,190,2.3,146,1.8,44,0.5,2530,31.1
E02004876,7971,100,4398,55.2,4181,52.5,217,2.7,107,1.3,80,1,27,0.3,3466,43.5
E02004877,4338,100,2657,61.2,2582,59.5,75,1.7,83,1.9,68,1.6,15,0.3,1598,36.8
E02004896,6836,100,3731,54.6,3559,52.1,172,2.5,122,1.8,107,1.6,15,0.2,2983,43.6
E02004897,5483,100,3237,59,3125,57,112,2,115,2.1,87,1.6,28,0.5,2131,38.9
E02004898,6303,100,3622,57.5,3411,54.1,211,3.3,144,2.3,99,1.6,45,0.7,2537,40.3
E02004899,4309,100,2731,63.4,2628,61,103,2.4,51,1.2,39,0.9,12,0.3,1527,35.4
E02004900,6612,100,4003,60.5,3868,58.5,135,2,91,1.4,74,1.1,17,0.3,2518,38.1
E02004901,7957,100,5182,65.1,4888,61.4,294,3.7,156,2,116,1.5,40,0.5,2619,32.9
E02004902,6245,100,4151,66.5,3928,62.9,223,3.6,130,2.1,102,1.6,28,0.4,1964,31.4
E02004903,5920,100,3869,65.4,3706,62.6,163,2.8,121,2,93,1.6,28,0.5,1930,32.6
E02004904,5466,100,3661,67,3455,63.2,206,3.8,121,2.2,89,1.6,32,0.6,1684,30.8
E02004905,5256,100,3330,63.4,3203,60.9,127,2.4,80,1.5,65,1.2,15,0.3,1846,35.1
E02004906,8602,100,5812,67.6,5552,64.5,260,3,178,2.1,153,1.8,25,0.3,2612,30.4
E02004907,8637,100,5471,63.3,5251,60.8,220,2.5,185,2.1,148,1.7,37,0.4,2981,34.5
E02004908,8568,100,5136,59.9,4941,57.7,195,2.3,95,1.1,79,0.9,16,0.2,3337,38.9
E02004909,4696,100,3213,68.4,3130,66.7,83,1.8,64,1.4,49,1,15,0.3,1419,30.2
E02004910,9364,100,6024,64.3,5857,62.5,167,1.8,136,1.5,104,1.1,32,0.3,3204,34.2
E02004911,5465,100,3291,60.2,3157,57.8,134,2.5,73,1.3,56,1,17,0.3,2101,38.4
E02004912,8739,100,5690,65.1,5493,62.9,197,2.3,182,2.1,157,1.8,25,0.3,2867,32.8
E02004914,6417,100,4132,64.4,3910,60.9,222,3.5,82,1.3,61,1,21,0.3,2203,34.3
E02004915,4543,100,2809,61.8,2660,58.6,149,3.3,86,1.9,64,1.4,22,0.5,1648,36.3
E02004916,6057,100,3486,57.6,3349,55.3,137,2.3,89,1.5,71,1.2,18,0.3,2482,41
E02004917,5255,100,2969,56.5,2822,53.7,147,2.8,78,1.5,60,1.1,18,0.3,2208,42
E02004918,6631,100,4796,72.3,4622,69.7,174,2.6,119,1.8,100,1.5,19,0.3,1716,25.9
E02004919,6138,100,4090,66.6,3932,64.1,158,2.6,139,2.3,107,1.7,32,0.5,1909,31.1
E02004920,9351,100,5612,60,5381,57.5,231,2.5,141,1.5,106,1.1,35,0.4,3598,38.5
E02004921,6258,100,4050,64.7,3917,62.6,133,2.1,95,1.5,69,1.1,26,0.4,2113,33.8
E02004922,8238,100,4951,60.1,4815,58.4,136,1.7,136,1.7,112,1.4,24,0.3,3151,38.2
E02004923,8528,100,5176,60.7,5017,58.8,159,1.9,141,1.7,109,1.3,32,0.4,3211,37.7
E02007088,6330,100,3770,59.6,3663,57.9,107,1.7,100,1.6,66,1,34,0.5,2460,38.9
E02007089,5741,100,4170,72.6,4045,70.5,125,2.2,125,2.2,102,1.8,23,0.4,1446,25.2
E02004956,7414,100,4748,64,4571,61.7,177,2.4,107,1.4,89,1.2,18,0.2,2559,34.5
E02004957,8309,100,5546,66.7,5316,64,230,2.8,140,1.7,122,1.5,18,0.2,2623,31.6
E02004958,6308,100,3939,62.4,3817,60.5,122,1.9,111,1.8,83,1.3,28,0.4,2258,35.8
E02004959,5144,100,3082,59.9,2984,58,98,1.9,62,1.2,45,0.9,17,0.3,2000,38.9
E02004960,4553,100,2773,60.9,2675,58.8,98,2.2,100,2.2,84,1.8,16,0.4,1680,36.9
E02004961,7684,100,4999,65.1,4837,62.9,162,2.1,147,1.9,114,1.5,33,0.4,2538,33
E02004962,7223,100,4793,66.4,4584,63.5,209,2.9,120,1.7,97,1.3,23,0.3,2310,32
E02004963,5893,100,3877,65.8,3700,62.8,177,3,105,1.8,77,1.3,28,0.5,1911,32.4
E02004964,4507,100,2947,65.4,2802,62.2,145,3.2,68,1.5,56,1.2,12,0.3,1492,33.1
E02004965,5648,100,3335,59,3196,56.6,139,2.5,72,1.3,52,0.9,20,0.4,2241,39.7
E02004966,6139,100,3770,61.4,3688,60.1,82,1.3,66,1.1,51,0.8,15,0.2,2303,37.5
E02004967,6169,100,4055,65.7,3808,61.7,247,4,131,2.1,103,1.7,28,0.5,1983,32.1
E02004968,6006,100,3883,64.7,3700,61.6,183,3,93,1.5,68,1.1,25,0.4,2030,33.8
E02004969,5776,100,3764,65.2,3613,62.6,151,2.6,120,2.1,92,1.6,28,0.5,1892,32.8
E02004970,6519,100,4185,64.2,3952,60.6,233,3.6,125,1.9,102,1.6,23,0.4,2209,33.9
E02004971,6682,100,4386,65.6,4173,62.5,213,3.2,204,3.1,155,2.3,49,0.7,2092,31.3
E02004972,4995,100,3256,65.2,3137,62.8,119,2.4,93,1.9,73,1.5,20,0.4,1646,33
E02004973,6849,100,4962,72.4,4723,69,239,3.5,204,3,174,2.5,30,0.4,1683,24.6
E02004974,7319,100,4744,64.8,4554,62.2,190,2.6,125,1.7,99,1.4,26,0.4,2450,33.5
E02004975,6537,100,4034,61.7,3849,58.9,185,2.8,145,2.2,104,1.6,41,0.6,2358,36.1
E02004976,9345,100,6735,72.1,6316,67.6,419,4.5,279,3,226,2.4,53,0.6,2331,24.9
E02004977,7134,100,5027,70.5,4771,66.9,256,3.6,200,2.8,168,2.4,32,0.4,1907,26.7
E02004978,7982,100,5217,65.4,4910,61.5,307,3.8,212,2.7,172,2.2,40,0.5,2553,32
E02004979,5829,100,3845,66,3654,62.7,191,3.3,111,1.9,80,1.4,31,0.5,1873,32.1
E02005503,6255,100,3484,55.7,3380,54,104,1.7,75,1.2,62,1,13,0.2,2696,43.1
E02005504,7853,100,4106,52.3,3982,50.7,124,1.6,81,1,66,0.8,15,0.2,3666,46.7
E02005505,6305,100,3422,54.3,3286,52.1,136,2.2,129,2,96,1.5,33,0.5,2754,43.7
E02005506,5914,100,3277,55.4,3158,53.4,119,2,87,1.5,66,1.1,21,0.4,2550,43.1
E02005507,9600,100,5468,57,5225,54.4,243,2.5,145,1.5,106,1.1,39,0.4,3987,41.5
E02005508,6176,100,3466,56.1,3363,54.5,103,1.7,68,1.1,59,1,9,0.1,2642,42.8
E02005509,7254,100,3461,47.7,3285,45.3,176,2.4,67,0.9,45,0.6,22,0.3,3726,51.4
E02005510,6322,100,3190,50.5,3100,49,90,1.4,93,1.5,69,1.1,24,0.4,3039,48.1
E02005511,7651,100,4110,53.7,3966,51.8,144,1.9,64,0.8,52,0.7,12,0.2,3477,45.4
E02005512,8476,100,4814,56.8,4604,54.3,210,2.5,111,1.3,92,1.1,19,0.2,3551,41.9
E02005513,8776,100,5274,60.1,5129,58.4,145,1.7,122,1.4,104,1.2,18,0.2,3380,38.5
E02005514,5817,100,3196,54.9,3090,53.1,106,1.8,60,1,47,0.8,13,0.2,2561,44
E02005515,5404,100,3209,59.4,3086,57.1,123,2.3,72,1.3,56,1,16,0.3,2123,39.3
E02005516,5919,100,3353,56.6,3267,55.2,86,1.5,86,1.5,69,1.2,17,0.3,2480,41.9
E02005517,4560,100,2901,63.6,2754,60.4,147,3.2,98,2.1,76,1.7,22,0.5,1561,34.2
E02005518,8837,100,5924,67,5739,64.9,185,2.1,136,1.5,110,1.2,26,0.3,2777,31.4
E02005519,6743,100,4189,62.1,3969,58.9,220,3.3,105,1.6,83,1.2,22,0.3,2449,36.3
E02005520,7464,100,3846,51.5,3701,49.6,145,1.9,115,1.5,90,1.2,25,0.3,3503,46.9
E02005521,7324,100,4192,57.2,4080,55.7,112,1.5,93,1.3,77,1.1,16,0.2,3039,41.5
E02005522,4657,100,2700,58,2613,56.1,87,1.9,69,1.5,52,1.1,17,0.4,1888,40.5
E02005523,7030,100,4388,62.4,4273,60.8,115,1.6,123,1.7,92,1.3,31,0.4,2519,35.8
E02005524,4522,100,2569,56.8,2505,55.4,64,1.4,71,1.6,51,1.1,20,0.4,1882,41.6
E02005525,8190,100,4921,60.1,4776,58.3,145,1.8,150,1.8,121,1.5,29,0.4,3119,38.1
E02005526,4474,100,2607,58.3,2523,56.4,84,1.9,64,1.4,52,1.2,12,0.3,1803,40.3
E02005527,7556,100,4356,57.6,4259,56.4,97,1.3,101,1.3,75,1,26,0.3,3099,41
E02005528,7145,100,4219,59,4089,57.2,130,1.8,109,1.5,88,1.2,21,0.3,2817,39.4
E02005529,4900,100,2513,51.3,2432,49.6,81,1.7,66,1.3,53,1.1,13,0.3,2321,47.4
E02005530,4592,100,2668,58.1,2595,56.5,73,1.6,70,1.5,60,1.3,10,0.2,1854,40.4
E02005531,4471,100,2566,57.4,2487,55.6,79,1.8,65,1.5,51,1.1,14,0.3,1840,41.2
E02005532,7976,100,4720,59.2,4597,57.6,123,1.5,108,1.4,75,0.9,33,0.4,3148,39.5
E02005533,7598,100,4133,54.4,4006,52.7,127,1.7,118,1.6,83,1.1,35,0.5,3347,44.1
E02005534,6270,100,3497,55.8,3376,53.8,121,1.9,76,1.2,70,1.1,6,0.1,2697,43
E02005535,5935,100,3675,61.9,3565,60.1,110,1.9,102,1.7,79,1.3,23,0.4,2158,36.4
E02005536,5279,100,2908,55.1,2830,53.6,78,1.5,70,1.3,51,1,19,0.4,2301,43.6
E02005537,5123,100,2724,53.2,2615,51,109,2.1,57,1.1,45,0.9,12,0.2,2342,45.7
E02005538,8490,100,4099,48.3,3892,45.8,207,2.4,109,1.3,80,0.9,29,0.3,4282,50.4
E02005539,6811,100,3598,52.8,3448,50.6,150,2.2,87,1.3,64,0.9,23,0.3,3126,45.9
E02005540,7669,100,3571,46.6,3383,44.1,188,2.5,124,1.6,97,1.3,27,0.4,3974,51.8
E02005541,4847,100,2446,50.5,2248,46.4,198,4.1,79,1.6,41,0.8,38,0.8,2322,47.9
E02005542,5790,100,3167,54.7,2839,49,328,5.7,78,1.3,55,0.9,23,0.4,2545,44
E02005543,7267,100,3845,52.9,3374,46.4,471,6.5,101,1.4,74,1,27,0.4,3321,45.7
E02005544,5596,100,3207,57.3,2932,52.4,275,4.9,85,1.5,58,1,27,0.5,2304,41.2
E02005545,5480,100,2955,53.9,2835,51.7,120,2.2,107,2,70,1.3,37,0.7,2418,44.1
E02005546,6463,100,3367,52.1,3099,47.9,268,4.1,94,1.5,64,1,30,0.5,3002,46.4
E02005547,7137,100,3873,54.3,3626,50.8,247,3.5,112,1.6,83,1.2,29,0.4,3152,44.2
E02005548,5916,100,3051,51.6,2834,47.9,217,3.7,111,1.9,75,1.3,36,0.6,2754,46.6
E02005549,4810,100,2510,52.2,2379,49.5,131,2.7,64,1.3,48,1,16,0.3,2236,46.5
E02005550,6436,100,3547,55.1,3388,52.6,159,2.5,90,1.4,58,0.9,32,0.5,2799,43.5
E02005551,4727,100,1822,38.5,1713,36.2,109,2.3,28,0.6,13,0.3,15,0.3,2877,60.9
E02005552,5727,100,2746,47.9,2635,46,111,1.9,69,1.2,44,0.8,25,0.4,2912,50.8
E02005553,7757,100,3255,42,3133,40.4,122,1.6,69,0.9,46,0.6,23,0.3,4433,57.1
E02005554,6121,100,2852,46.6,2727,44.6,125,2,51,0.8,40,0.7,11,0.2,3218,52.6
E02005555,5769,100,3111,53.9,3038,52.7,73,1.3,96,1.7,72,1.2,24,0.4,2562,44.4
E02005556,6412,100,3944,61.5,3855,60.1,89,1.4,106,1.7,84,1.3,22,0.3,2362,36.8
E02005557,5253,100,3264,62.1,3060,58.3,204,3.9,87,1.7,62,1.2,25,0.5,1902,36.2
E02005558,6175,100,3357,54.4,3246,52.6,111,1.8,82,1.3,61,1,21,0.3,2736,44.3
E02005559,5973,100,3589,60.1,3444,57.7,145,2.4,68,1.1,50,0.8,18,0.3,2316,38.8
E02005560,7037,100,4656,66.2,4424,62.9,232,3.3,105,1.5,76,1.1,29,0.4,2276,32.3
E02005561,8869,100,5498,62,5204,58.7,294,3.3,138,1.6,106,1.2,32,0.4,3233,36.5
E02005562,6314,100,3401,53.9,3281,52,120,1.9,68,1.1,48,0.8,20,0.3,2845,45.1
E02005563,6724,100,3803,56.6,3680,54.7,123,1.8,79,1.2,61,0.9,18,0.3,2842,42.3
E02005564,8100,100,4737,58.5,4602,56.8,135,1.7,103,1.3,82,1,21,0.3,3260,40.2
E02005565,6148,100,3574,58.1,3449,56.1,125,2,88,1.4,65,1.1,23,0.4,2486,40.4
E02005566,8703,100,4816,55.3,4636,53.3,180,2.1,95,1.1,79,0.9,16,0.2,3792,43.6
E02005567,9505,100,4878,51.3,4667,49.1,211,2.2,101,1.1,64,0.7,37,0.4,4526,47.6
E02005568,6443,100,3527,54.7,3400,52.8,127,2,49,0.8,37,0.6,12,0.2,2867,44.5
E02005569,7138,100,4006,56.1,3868,54.2,138,1.9,92,1.3,71,1,21,0.3,3040,42.6
E02005570,6230,100,2586,41.5,2491,40,95,1.5,65,1,48,0.8,17,0.3,3579,57.4
E02005571,5097,100,2359,46.3,2276,44.7,83,1.6,43,0.8,32,0.6,11,0.2,2695,52.9
E02005572,6633,100,2886,43.5,2739,41.3,147,2.2,64,1,47,0.7,17,0.3,3683,55.5
E02005573,5000,100,1932,38.6,1836,36.7,96,1.9,44,0.9,28,0.6,16,0.3,3024,60.5
E02005574,6113,100,2824,46.2,2726,44.6,98,1.6,48,0.8,36,0.6,12,0.2,3241,53
E02005575,6083,100,3043,50,2935,48.2,108,1.8,57,0.9,50,0.8,7,0.1,2983,49
E02005576,5800,100,2503,43.2,2380,41,123,2.1,39,0.7,21,0.4,18,0.3,3258,56.2
E02005577,5129,100,2679,52.2,2605,50.8,74,1.4,45,0.9,38,0.7,7,0.1,2405,46.9
E02005578,4991,100,2824,56.6,2727,54.6,97,1.9,51,1,45,0.9,6,0.1,2116,42.4
E02005580,6780,100,3573,52.7,3423,50.5,150,2.2,62,0.9,54,0.8,8,0.1,3145,46.4
E02005581,6761,100,3524,52.1,3350,49.5,174,2.6,60,0.9,50,0.7,10,0.1,3177,47
E02005582,5861,100,3016,51.5,2878,49.1,138,2.4,64,1.1,53,0.9,11,0.2,2781,47.4
E02005583,7633,100,3404,44.6,3265,42.8,139,1.8,49,0.6,39,0.5,10,0.1,4180,54.8
E02007032,5786,100,2872,49.6,2734,47.3,138,2.4,58,1,43,0.7,15,0.3,2856,49.4
E02007033,5252,100,2770,52.7,2650,50.5,120,2.3,72,1.4,57,1.1,15,0.3,2410,45.9
E02005584,8934,100,5563,62.3,5271,59,292,3.3,157,1.8,110,1.2,47,0.5,3214,36
E02005585,8852,100,5356,60.5,5017,56.7,339,3.8,182,2.1,143,1.6,39,0.4,3314,37.4
E02005586,8760,100,6061,69.2,5789,66.1,272,3.1,191,2.2,140,1.6,51,0.6,2508,28.6
E02005587,8280,100,4498,54.3,4207,50.8,291,3.5,146,1.8,104,1.3,42,0.5,3636,43.9
E02005588,10504,100,5109,48.6,4814,45.8,295,2.8,686,6.5,451,4.3,235,2.2,4709,44.8
E02005589,9775,100,5093,52.1,4792,49,301,3.1,501,5.1,329,3.4,172,1.8,4181,42.8
E02005592,7937,100,4727,59.6,4539,57.2,188,2.4,503,6.3,389,4.9,114,1.4,2707,34.1
E02005593,9579,100,2423,25.3,2276,23.8,147,1.5,1255,13.1,763,8,492,5.1,5901,61.6
E02005594,9554,100,5403,56.6,5123,53.6,280,2.9,413,4.3,320,3.3,93,1,3738,39.1
E02005595,7953,100,3814,48,3695,46.5,119,1.5,256,3.2,191,2.4,65,0.8,3883,48.8
E02005596,7952,100,4612,58,4376,55,236,3,134,1.7,94,1.2,40,0.5,3206,40.3
E02006907,6525,100,4140,63.4,3882,59.5,258,4,237,3.6,185,2.8,52,0.8,2148,32.9
E02006908,4803,100,3159,65.8,2971,61.9,188,3.9,74,1.5,61,1.3,13,0.3,1570,32.7
E02007052,5618,100,3202,57,2940,52.3,262,4.7,139,2.5,117,2.1,22,0.4,2277,40.5
E02007053,5736,100,2550,44.5,2357,41.1,193,3.4,471,8.2,271,4.7,200,3.5,2715,47.3
E02005598,8018,100,4801,59.9,4698,58.6,103,1.3,117,1.5,99,1.2,18,0.2,3100,38.7
E02005599,5803,100,3423,59,3321,57.2,102,1.8,87,1.5,75,1.3,12,0.2,2293,39.5
E02005600,5139,100,2710,52.7,2636,51.3,74,1.4,93,1.8,61,1.2,32,0.6,2336,45.5
E02005601,4753,100,2434,51.2,2344,49.3,90,1.9,63,1.3,50,1.1,13,0.3,2256,47.5
E02005602,10526,100,6171,58.6,6009,57.1,162,1.5,154,1.5,118,1.1,36,0.3,4201,39.9
E02005603,9985,100,6559,65.7,6399,64.1,160,1.6,187,1.9,157,1.6,30,0.3,3239,32.4
E02005604,7464,100,4019,53.8,3892,52.1,127,1.7,99,1.3,66,0.9,33,0.4,3346,44.8
E02005605,8800,100,5176,58.8,5044,57.3,132,1.5,113,1.3,92,1,21,0.2,3511,39.9
E02005606,4998,100,2892,57.9,2801,56,91,1.8,70,1.4,52,1,18,0.4,2036,40.7
E02005607,9591,100,5703,59.5,5530,57.7,173,1.8,152,1.6,118,1.2,34,0.4,3736,39
E02005608,6561,100,3554,54.2,3432,52.3,122,1.9,79,1.2,59,0.9,20,0.3,2928,44.6
E02005609,6301,100,3414,54.2,3289,52.2,125,2,61,1,40,0.6,21,0.3,2826,44.9
E02005610,6988,100,3884,55.6,3770,53.9,114,1.6,68,1,58,0.8,10,0.1,3036,43.4
E02005611,9257,100,5311,57.4,5126,55.4,185,2,112,1.2,91,1,21,0.2,3834,41.4
E02007054,6657,100,4724,71,4599,69.1,125,1.9,131,2,112,1.7,19,0.3,1802,27.1
E02007055,6378,100,3635,57,3536,55.4,99,1.6,93,1.5,72,1.1,21,0.3,2650,41.5
E02006227,5571,100,2897,52,2776,49.8,121,2.2,56,1,46,0.8,10,0.2,2618,47
E02006228,5144,100,2997,58.3,2900,56.4,97,1.9,74,1.4,65,1.3,9,0.2,2073,40.3
E02006229,5310,100,2774,52.2,2677,50.4,97,1.8,76,1.4,55,1,21,0.4,2460,46.3
E02006230,9085,100,5012,55.2,4832,53.2,180,2,181,2,150,1.7,31,0.3,3892,42.8
E02006231,7212,100,4606,63.9,4481,62.1,125,1.7,107,1.5,84,1.2,23,0.3,2499,34.7
E02006232,5170,100,2865,55.4,2756,53.3,109,2.1,78,1.5,52,1,26,0.5,2227,43.1
E02006233,9846,100,5538,56.2,5202,52.8,336,3.4,112,1.1,70,0.7,42,0.4,4196,42.6
E02006234,7975,100,4838,60.7,4584,57.5,254,3.2,159,2,131,1.6,28,0.4,2978,37.3
E02006235,6948,100,3838,55.2,3745,53.9,93,1.3,75,1.1,55,0.8,20,0.3,3035,43.7
E02006236,8800,100,4835,54.9,4730,53.8,105,1.2,154,1.8,128,1.5,26,0.3,3811,43.3
E02006237,6323,100,3432,54.3,3348,52.9,84,1.3,126,2,93,1.5,33,0.5,2765,43.7
E02006245,6534,100,3695,56.6,3500,53.6,195,3,122,1.9,77,1.2,45,0.7,2717,41.6
E02006246,6138,100,3686,60.1,3567,58.1,119,1.9,113,1.8,89,1.4,24,0.4,2339,38.1
E02006247,7129,100,4606,64.6,4378,61.4,228,3.2,138,1.9,108,1.5,30,0.4,2385,33.5
E02006248,6658,100,3963,59.5,3835,57.6,128,1.9,182,2.7,132,2,50,0.8,2513,37.7
E02006249,6910,100,4123,59.7,3963,57.4,160,2.3,138,2,101,1.5,37,0.5,2649,38.3
E02006250,8112,100,5392,66.5,5019,61.9,373,4.6,192,2.4,144,1.8,48,0.6,2528,31.2
E02006251,8937,100,6130,68.6,5734,64.2,396,4.4,262,2.9,198,2.2,64,0.7,2545,28.5
E02006252,7736,100,5194,67.1,5022,64.9,172,2.2,143,1.8,94,1.2,49,0.6,2399,31
E02006253,6193,100,3464,55.9,3358,54.2,106,1.7,124,2,88,1.4,36,0.6,2605,42.1
E02006254,7451,100,4542,61,4254,57.1,288,3.9,147,2,112,1.5,35,0.5,2762,37.1
E02006255,6780,100,4245,62.6,4071,60,174,2.6,241,3.6,180,2.7,61,0.9,2294,33.8
E02006256,7773,100,4862,62.5,4539,58.4,323,4.2,164,2.1,123,1.6,41,0.5,2747,35.3
E02006257,5459,100,3029,55.5,2899,53.1,130,2.4,88,1.6,68,1.2,20,0.4,2342,42.9
E02006258,7509,100,4581,61,4339,57.8,242,3.2,172,2.3,130,1.7,42,0.6,2756,36.7
E02006259,5700,100,3094,54.3,2910,51.1,184,3.2,113,2,85,1.5,28,0.5,2493,43.7
E02006260,6800,100,4006,58.9,3790,55.7,216,3.2,155,2.3,107,1.6,48,0.7,2639,38.8
E02006261,6826,100,3543,51.9,3435,50.3,108,1.6,104,1.5,88,1.3,16,0.2,3179,46.6
E02006262,7641,100,4305,56.3,4168,54.5,137,1.8,77,1,53,0.7,24,0.3,3259,42.7
E02006263,6462,100,3491,54,3383,52.4,108,1.7,80,1.2,66,1,14,0.2,2891,44.7
E02006264,7348,100,4490,61.1,4388,59.7,102,1.4,111,1.5,90,1.2,21,0.3,2747,37.4
E02006265,6241,100,3527,56.5,3425,54.9,102,1.6,80,1.3,64,1,16,0.3,2634,42.2
E02006266,8005,100,4420,55.2,4267,53.3,153,1.9,79,1,59,0.7,20,0.2,3506,43.8
E02006267,7076,100,4107,58,4002,56.6,105,1.5,113,1.6,93,1.3,20,0.3,2856,40.4
E02006268,5104,100,2703,53,2551,50,152,3,65,1.3,52,1,13,0.3,2336,45.8
E02006269,6445,100,3884,60.3,3771,58.5,113,1.8,95,1.5,74,1.1,21,0.3,2466,38.3
E02006270,10371,100,7100,68.5,6915,66.7,185,1.8,200,1.9,159,1.5,41,0.4,3071,29.6
E02006271,8271,100,5284,63.9,5164,62.4,120,1.5,105,1.3,84,1,21,0.3,2882,34.8
E02006272,6517,100,3673,56.4,3582,55,91,1.4,127,1.9,90,1.4,37,0.6,2717,41.7
E02004924,5782,100,3696,63.9,3607,62.4,89,1.5,93,1.6,71,1.2,22,0.4,1993,34.5
E02004925,5876,100,3738,63.6,3600,61.3,138,2.3,91,1.5,73,1.2,18,0.3,2047,34.8
E02004926,6256,100,3754,60,3631,58,123,2,94,1.5,74,1.2,20,0.3,2408,38.5
E02004927,5229,100,3117,59.6,3011,57.6,106,2,61,1.2,44,0.8,17,0.3,2051,39.2
E02004928,5367,100,3192,59.5,3083,57.4,109,2,74,1.4,51,1,23,0.4,2101,39.1
E02004929,5095,100,2941,57.7,2868,56.3,73,1.4,78,1.5,67,1.3,11,0.2,2076,40.7
E02004930,5532,100,3513,63.5,3401,61.5,112,2,90,1.6,76,1.4,14,0.3,1929,34.9
E02004931,5366,100,3369,62.8,3269,60.9,100,1.9,109,2,88,1.6,21,0.4,1888,35.2
E02004932,5906,100,3785,64.1,3610,61.1,175,3,103,1.7,77,1.3,26,0.4,2018,34.2
E02004933,5300,100,3387,63.9,3285,62,102,1.9,80,1.5,68,1.3,12,0.2,1833,34.6
E02004934,6222,100,4403,70.8,4248,68.3,155,2.5,109,1.8,92,1.5,17,0.3,1710,27.5
E02004935,7493,100,5656,75.5,5442,72.6,214,2.9,90,1.2,76,1,14,0.2,1747,23.3
E02004936,4930,100,3493,70.9,3374,68.4,119,2.4,93,1.9,78,1.6,15,0.3,1344,27.3
E02004937,5894,100,3467,58.8,3362,57,105,1.8,81,1.4,62,1.1,19,0.3,2346,39.8
E02004939,5205,100,3230,62.1,3106,59.7,124,2.4,124,2.4,98,1.9,26,0.5,1851,35.6
E02004940,5891,100,3878,65.8,3718,63.1,160,2.7,119,2,99,1.7,20,0.3,1894,32.2
E02004941,7836,100,5089,64.9,4872,62.2,217,2.8,184,2.3,155,2,29,0.4,2563,32.7
E02004942,5202,100,3119,60,3002,57.7,117,2.2,62,1.2,52,1,10,0.2,2021,38.9
E02004943,6766,100,3992,59,3859,57,133,2,115,1.7,93,1.4,22,0.3,2659,39.3
E02007090,4933,100,3055,61.9,2930,59.4,125,2.5,115,2.3,90,1.8,25,0.5,1763,35.7
E02004980,5176,100,3048,58.9,2969,57.4,79,1.5,84,1.6,75,1.4,9,0.2,2044,39.5
E02004981,6518,100,4168,63.9,4018,61.6,150,2.3,110,1.7,79,1.2,31,0.5,2240,34.4
E02004982,4687,100,2794,59.6,2693,57.5,101,2.2,88,1.9,68,1.5,20,0.4,1805,38.5
E02004983,4836,100,3065,63.4,2924,60.5,141,2.9,103,2.1,84,1.7,19,0.4,1668,34.5
E02004984,5241,100,3293,62.8,3170,60.5,123,2.3,86,1.6,68,1.3,18,0.3,1862,35.5
E02004985,5750,100,3267,56.8,3165,55,102,1.8,101,1.8,67,1.2,34,0.6,2382,41.4
E02004986,6816,100,4740,69.5,4519,66.3,221,3.2,143,2.1,112,1.6,31,0.5,1933,28.4
E02004987,5988,100,4071,68,3914,65.4,157,2.6,124,2.1,88,1.5,36,0.6,1793,29.9
E02004988,6030,100,4002,66.4,3831,63.5,171,2.8,110,1.8,84,1.4,26,0.4,1918,31.8
E02004989,10617,100,4968,46.8,4768,44.9,200,1.9,1402,13.2,886,8.3,516,4.9,4247,40
E02004990,6026,100,3781,62.7,3627,60.2,154,2.6,222,3.7,181,3,41,0.7,2023,33.6
E02004991,6630,100,3824,57.7,3642,54.9,182,2.7,653,9.8,528,8,125,1.9,2153,32.5
E02004992,8819,100,3570,40.5,3358,38.1,212,2.4,1540,17.5,1039,11.8,501,5.7,3709,42.1
E02004994,5039,100,2960,58.7,2852,56.6,108,2.1,89,1.8,72,1.4,17,0.3,1990,39.5
E02004995,4712,100,2728,57.9,2627,55.8,101,2.1,81,1.7,61,1.3,20,0.4,1903,40.4
E02007092,4589,100,2602,56.7,2475,53.9,127,2.8,130,2.8,104,2.3,26,0.6,1857,40.5
E02004878,7382,100,4574,62,4441,60.2,133,1.8,120,1.6,97,1.3,23,0.3,2688,36.4
E02004880,8560,100,5618,65.6,5435,63.5,183,2.1,131,1.5,94,1.1,37,0.4,2811,32.8
E02004881,5591,100,3605,64.5,3471,62.1,134,2.4,82,1.5,63,1.1,19,0.3,1904,34.1
E02004882,6709,100,4394,65.5,4215,62.8,179,2.7,120,1.8,107,1.6,13,0.2,2195,32.7
E02004883,5036,100,3227,64.1,3133,62.2,94,1.9,73,1.4,55,1.1,18,0.4,1736,34.5
E02004884,8508,100,5777,67.9,5516,64.8,261,3.1,125,1.5,104,1.2,21,0.2,2606,30.6
E02004885,6843,100,4550,66.5,4405,64.4,145,2.1,95,1.4,80,1.2,15,0.2,2198,32.1
E02004886,5384,100,3303,61.3,3193,59.3,110,2,61,1.1,49,0.9,12,0.2,2020,37.5
E02004887,6222,100,3775,60.7,3672,59,103,1.7,105,1.7,77,1.2,28,0.5,2342,37.6
E02004888,7128,100,4249,59.6,4100,57.5,149,2.1,107,1.5,75,1.1,32,0.4,2772,38.9
E02004889,9016,100,5764,63.9,5536,61.4,228,2.5,140,1.6,114,1.3,26,0.3,3112,34.5
E02004890,6981,100,4675,67,4537,65,138,2,105,1.5,84,1.2,21,0.3,2201,31.5
E02004891,6337,100,3980,62.8,3834,60.5,146,2.3,69,1.1,50,0.8,19,0.3,2288,36.1
E02004892,4636,100,3020,65.1,2900,62.6,120,2.6,67,1.4,43,0.9,24,0.5,1549,33.4
E02004893,4642,100,3370,72.6,3266,70.4,104,2.2,80,1.7,62,1.3,18,0.4,1192,25.7
E02004894,7910,100,5375,68,5182,65.5,193,2.4,96,1.2,71,0.9,25,0.3,2439,30.8
E02004895,7556,100,4532,60,4397,58.2,135,1.8,122,1.6,90,1.2,32,0.4,2902,38.4
E02007093,6716,100,4041,60.2,3928,58.5,113,1.7,71,1.1,54,0.8,17,0.3,2604,38.8
E02004944,6194,100,4245,68.5,4070,65.7,175,2.8,155,2.5,119,1.9,36,0.6,1794,29
E02004945,9859,100,6450,65.4,6197,62.9,253,2.6,186,1.9,149,1.5,37,0.4,3223,32.7
E02004946,5124,100,3326,64.9,3171,61.9,155,3,97,1.9,75,1.5,22,0.4,1701,33.2
E02004948,4945,100,3095,62.6,2941,59.5,154,3.1,85,1.7,70,1.4,15,0.3,1765,35.7
E02004949,7122,100,4390,61.6,4178,58.7,212,3,149,2.1,120,1.7,29,0.4,2583,36.3
E02004950,5309,100,3508,66.1,3353,63.2,155,2.9,131,2.5,97,1.8,34,0.6,1670,31.5
E02004951,6388,100,4148,64.9,3902,61.1,246,3.9,157,2.5,122,1.9,35,0.5,2083,32.6
E02004952,5509,100,3566,64.7,3438,62.4,128,2.3,128,2.3,99,1.8,29,0.5,1815,32.9
E02004953,5019,100,3280,65.4,3120,62.2,160,3.2,134,2.7,95,1.9,39,0.8,1605,32
E02004954,5642,100,3666,65,3511,62.2,155,2.7,127,2.3,101,1.8,26,0.5,1849,32.8
E02004955,4803,100,3064,63.8,2957,61.6,107,2.2,78,1.6,54,1.1,24,0.5,1661,34.6
E02007091,5326,100,3551,66.7,3444,64.7,107,2,102,1.9,79,1.5,23,0.4,1673,31.4
E02006287,5497,100,2660,48.4,2586,47,74,1.3,52,0.9,37,0.7,15,0.3,2785,50.7
E02006288,8412,100,4568,54.3,4428,52.6,140,1.7,108,1.3,80,1,28,0.3,3736,44.4
E02006289,8122,100,4166,51.3,4006,49.3,160,2,91,1.1,73,0.9,18,0.2,3865,47.6
E02006290,6973,100,3469,49.7,3324,47.7,145,2.1,70,1,49,0.7,21,0.3,3434,49.2
E02006291,6496,100,3411,52.5,3296,50.7,115,1.8,85,1.3,58,0.9,27,0.4,3000,46.2
E02006292,5731,100,3126,54.5,3052,53.3,74,1.3,73,1.3,55,1,18,0.3,2532,44.2
E02006293,9324,100,5349,57.4,5065,54.3,284,3,140,1.5,108,1.2,32,0.3,3835,41.1
E02006294,6783,100,3328,49.1,3178,46.9,150,2.2,101,1.5,75,1.1,26,0.4,3354,49.4
E02006295,7675,100,4368,56.9,4267,55.6,101,1.3,119,1.6,89,1.2,30,0.4,3188,41.5
E02006296,10623,100,6363,59.9,6174,58.1,189,1.8,223,2.1,175,1.6,48,0.5,4037,38
E02006297,6819,100,3878,56.9,3796,55.7,82,1.2,95,1.4,77,1.1,18,0.3,2846,41.7
E02006298,7679,100,4500,58.6,4377,57,123,1.6,94,1.2,77,1,17,0.2,3085,40.2
E02006299,7289,100,3255,44.7,3152,43.2,103,1.4,106,1.5,88,1.2,18,0.2,3928,53.9
E02006300,6497,100,3766,58,3589,55.2,177,2.7,98,1.5,71,1.1,27,0.4,2633,40.5
E02006301,5409,100,2848,52.7,2706,50,142,2.6,59,1.1,48,0.9,11,0.2,2502,46.3
E02006302,5833,100,2869,49.2,2740,47,129,2.2,74,1.3,52,0.9,22,0.4,2890,49.5
E02006303,6238,100,3286,52.7,3065,49.1,221,3.5,99,1.6,59,0.9,40,0.6,2853,45.7
E02006304,6904,100,3408,49.4,3256,47.2,152,2.2,87,1.3,61,0.9,26,0.4,3409,49.4
E02006305,7595,100,4271,56.2,3927,51.7,344,4.5,159,2.1,111,1.5,48,0.6,3165,41.7
E02006306,6045,100,3147,52.1,2951,48.8,196,3.2,71,1.2,46,0.8,25,0.4,2827,46.8
E02006307,6407,100,3108,48.5,3010,47,98,1.5,83,1.3,59,0.9,24,0.4,3216,50.2
E02006308,6309,100,3263,51.7,2942,46.6,321,5.1,116,1.8,86,1.4,30,0.5,2930,46.4
E02006309,5595,100,2555,45.7,2371,42.4,184,3.3,64,1.1,42,0.8,22,0.4,2976,53.2
E02006310,6579,100,3906,59.4,3745,56.9,161,2.4,128,1.9,85,1.3,43,0.7,2545,38.7
E02006311,6920,100,3408,49.2,3260,47.1,148,2.1,81,1.2,61,0.9,20,0.3,3431,49.6
E02006312,7201,100,3948,54.8,3807,52.9,141,2,114,1.6,84,1.2,30,0.4,3139,43.6
E02006313,8465,100,4127,48.8,3973,46.9,154,1.8,119,1.4,91,1.1,28,0.3,4219,49.8
E02006314,6168,100,3298,53.5,3174,51.5,124,2,73,1.2,47,0.8,26,0.4,2797,45.3
E02006315,5088,100,2339,46,2222,43.7,117,2.3,56,1.1,41,0.8,15,0.3,2693,52.9
E02006316,6044,100,2907,48.1,2782,46,125,2.1,66,1.1,56,0.9,10,0.2,3071,50.8
E02006238,8100,100,4587,56.6,4394,54.2,193,2.4,113,1.4,93,1.1,20,0.2,3400,42
E02006239,6801,100,4313,63.4,4236,62.3,77,1.1,159,2.3,142,2.1,17,0.2,2329,34.2
E02006240,8099,100,5358,66.2,5221,64.5,137,1.7,162,2,144,1.8,18,0.2,2579,31.8
E02006241,7266,100,4323,59.5,4169,57.4,154,2.1,114,1.6,91,1.3,23,0.3,2829,38.9
E02006242,8391,100,5872,70,5696,67.9,176,2.1,165,2,145,1.7,20,0.2,2354,28.1
E02006243,7729,100,5318,68.8,5094,65.9,224,2.9,99,1.3,87,1.1,12,0.2,2312,29.9
E02006273,5788,100,3147,54.4,3059,52.9,88,1.5,71,1.2,54,0.9,17,0.3,2570,44.4
E02006274,5548,100,3483,62.8,3399,61.3,84,1.5,92,1.7,72,1.3,20,0.4,1973,35.6
E02006275,5597,100,3485,62.3,3315,59.2,170,3,121,2.2,86,1.5,35,0.6,1991,35.6
E02006276,6823,100,3835,56.2,3713,54.4,122,1.8,102,1.5,87,1.3,15,0.2,2886,42.3
E02006277,6126,100,4216,68.8,4118,67.2,98,1.6,142,2.3,125,2,17,0.3,1768,28.9
E02006278,7350,100,4471,60.8,4288,58.3,183,2.5,132,1.8,119,1.6,13,0.2,2747,37.4
E02006279,7276,100,4025,55.3,3882,53.4,143,2,93,1.3,74,1,19,0.3,3158,43.4
E02006280,8067,100,4545,56.3,4429,54.9,116,1.4,140,1.7,106,1.3,34,0.4,3382,41.9
E02006281,7205,100,3768,52.3,3643,50.6,125,1.7,116,1.6,90,1.2,26,0.4,3321,46.1
E02006282,5617,100,2948,52.5,2856,50.8,92,1.6,74,1.3,56,1,18,0.3,2595,46.2
E02006283,7089,100,3826,54,3651,51.5,175,2.5,99,1.4,62,0.9,37,0.5,3164,44.6
E02006284,6187,100,3935,63.6,3771,61,164,2.7,77,1.2,64,1,13,0.2,2175,35.2
E02006285,5992,100,4084,68.2,3936,65.7,148,2.5,120,2,98,1.6,22,0.4,1788,29.8
E02006286,8873,100,5742,64.7,5468,61.6,274,3.1,126,1.4,100,1.1,26,0.3,3005,33.9
E02006826,8189,100,5470,66.8,5279,64.5,191,2.3,125,1.5,97,1.2,28,0.3,2594,31.7
E02000001,8004,100,5555,69.4,5273,65.9,282,3.5,123,1.5,78,1,45,0.6,2326,29.1
E02000002,5985,100,3391,56.7,3112,52,279,4.7,201,3.4,126,2.1,75,1.3,2393,40
E02000003,8844,100,5349,60.5,4965,56.1,384,4.3,319,3.6,269,3,50,0.6,3176,35.9
E02000004,5315,100,3246,61.1,3022,56.9,224,4.2,126,2.4,92,1.7,34,0.6,1943,36.6
E02000005,7987,100,5043,63.1,4720,59.1,323,4,209,2.6,143,1.8,66,0.8,2735,34.2
E02000007,7469,100,4395,58.8,4067,54.5,328,4.4,269,3.6,206,2.8,63,0.8,2805,37.6
E02000008,9850,100,5943,60.3,5454,55.4,489,5,321,3.3,245,2.5,76,0.8,3586,36.4
E02000009,9354,100,5616,60,5173,55.3,443,4.7,323,3.5,259,2.8,64,0.7,3415,36.5
E02000010,7075,100,4357,61.6,4031,57,326,4.6,258,3.6,198,2.8,60,0.8,2460,34.8
E02000011,5418,100,3199,59,2968,54.8,231,4.3,172,3.2,133,2.5,39,0.7,2047,37.8
E02000012,8847,100,5142,58.1,4802,54.3,340,3.8,302,3.4,222,2.5,80,0.9,3403,38.5
E02000013,6963,100,4109,59,3806,54.7,303,4.4,243,3.5,196,2.8,47,0.7,2611,37.5
E02000014,7433,100,4533,61,4169,56.1,364,4.9,284,3.8,213,2.9,71,1,2616,35.2
E02000015,6029,100,3697,61.3,3368,55.9,329,5.5,213,3.5,145,2.4,68,1.1,2119,35.1
E02000016,7581,100,4733,62.4,4259,56.2,474,6.3,388,5.1,290,3.8,98,1.3,2460,32.4
E02000017,7140,100,4259,59.6,3941,55.2,318,4.5,270,3.8,209,2.9,61,0.9,2611,36.6
E02000018,6998,100,4202,60,3829,54.7,373,5.3,228,3.3,160,2.3,68,1,2568,36.7
E02000019,7024,100,4302,61.2,3954,56.3,348,5,259,3.7,200,2.8,59,0.8,2463,35.1
E02000020,10264,100,6453,62.9,5961,58.1,492,4.8,397,3.9,296,2.9,101,1,3414,33.3
E02000021,6368,100,3835,60.2,3533,55.5,302,4.7,215,3.4,173,2.7,42,0.7,2318,36.4
E02000022,5420,100,3437,63.4,3152,58.2,285,5.3,290,5.4,205,3.8,85,1.6,1693,31.2
E02000023,5606,100,3327,59.3,3038,54.2,289,5.2,252,4.5,185,3.3,67,1.2,2027,36.2
E02006799,8774,100,5262,60,4864,55.4,398,4.5,295,3.4,232,2.6,63,0.7,3217,36.7
E02000024,8923,100,5511,61.8,5221,58.5,290,3.3,135,1.5,102,1.1,33,0.4,3277,36.7
E02000025,6987,100,4408,63.1,4117,58.9,291,4.2,107,1.5,79,1.1,28,0.4,2472,35.4
E02000026,5216,100,3089,59.2,2931,56.2,158,3,61,1.2,45,0.9,16,0.3,2066,39.6
E02000027,7728,100,4607,59.6,4322,55.9,285,3.7,150,1.9,104,1.3,46,0.6,2971,38.4
E02000028,5305,100,3376,63.6,3202,60.4,174,3.3,96,1.8,66,1.2,30,0.6,1833,34.6
E02000029,7435,100,4824,64.9,4505,60.6,319,4.3,161,2.2,115,1.5,46,0.6,2450,33
E02000030,7719,100,4473,57.9,4304,55.8,169,2.2,92,1.2,73,0.9,19,0.2,3154,40.9
E02000031,6807,100,4246,62.4,4023,59.1,223,3.3,93,1.4,65,1,28,0.4,2468,36.3
E02000032,6423,100,3909,60.9,3713,57.8,196,3.1,98,1.5,79,1.2,19,0.3,2416,37.6
E02000033,7146,100,4416,61.8,4167,58.3,249,3.5,157,2.2,125,1.7,32,0.4,2573,36
E02000034,7280,100,4560,62.6,4310,59.2,250,3.4,172,2.4,130,1.8,42,0.6,2548,35
E02000035,7087,100,4513,63.7,4236,59.8,277,3.9,129,1.8,87,1.2,42,0.6,2445,34.5
E02000036,8649,100,5361,62,5093,58.9,268,3.1,194,2.2,162,1.9,32,0.4,3094,35.8
E02000037,8209,100,5144,62.7,4865,59.3,279,3.4,167,2,117,1.4,50,0.6,2898,35.3
E02000038,8642,100,5366,62.1,5094,58.9,272,3.1,181,2.1,146,1.7,35,0.4,3095,35.8
E02000039,5656,100,3629,64.2,3464,61.2,165,2.9,90,1.6,67,1.2,23,0.4,1937,34.2
E02000040,7251,100,4461,61.5,4239,58.5,222,3.1,120,1.7,94,1.3,26,0.4,2670,36.8
E02000041,7451,100,4586,61.5,4304,57.8,282,3.8,212,2.8,175,2.3,37,0.5,2653,35.6
E02000042,9405,100,5789,61.6,5418,57.6,371,3.9,246,2.6,157,1.7,89,0.9,3370,35.8
E02000043,5892,100,3716,63.1,3570,60.6,146,2.5,81,1.4,66,1.1,15,0.3,2095,35.6
E02000044,6879,100,4380,63.7,4057,59,323,4.7,196,2.8,147,2.1,49,0.7,2303,33.5
E02000045,8284,100,5230,63.1,4834,58.4,396,4.8,183,2.2,138,1.7,45,0.5,2871,34.7
E02000046,5705,100,3948,69.2,3721,65.2,227,4,135,2.4,104,1.8,31,0.5,1622,28.4
E02000047,9576,100,5666,59.2,5216,54.5,450,4.7,280,2.9,225,2.3,55,0.6,3630,37.9
E02000048,8087,100,4958,61.3,4683,57.9,275,3.4,190,2.3,154,1.9,36,0.4,2939,36.3
E02000049,8019,100,4914,61.3,4476,55.8,438,5.5,249,3.1,175,2.2,74,0.9,2856,35.6
E02000050,8365,100,5185,62,4795,57.3,390,4.7,193,2.3,125,1.5,68,0.8,2987,35.7
E02000051,7495,100,4616,61.6,4242,56.6,374,5,127,1.7,100,1.3,27,0.4,2752,36.7
E02000052,7965,100,5317,66.8,5008,62.9,309,3.9,165,2.1,119,1.5,46,0.6,2483,31.2
E02000054,6220,100,3804,61.2,3599,57.9,205,3.3,275,4.4,197,3.2,78,1.3,2141,34.4
E02000055,9497,100,5843,61.5,5403,56.9,440,4.6,512,5.4,378,4,134,1.4,3142,33.1
E02000056,7202,100,4385,60.9,4209,58.4,176,2.4,81,1.1,54,0.7,27,0.4,2736,38
E02000057,5934,100,3596,60.6,3350,56.5,246,4.1,228,3.8,189,3.2,39,0.7,2110,35.6
E02000058,7960,100,4879,61.3,4656,58.5,223,2.8,133,1.7,102,1.3,31,0.4,2948,37
E02000059,9623,100,6210,64.5,5799,60.3,411,4.3,303,3.1,253,2.6,50,0.5,3110,32.3
E02000060,7995,100,4744,59.3,4520,56.5,224,2.8,188,2.4,154,1.9,34,0.4,3063,38.3
E02000061,6882,100,4316,62.7,4095,59.5,221,3.2,135,2,101,1.5,34,0.5,2431,35.3
E02000062,5463,100,3258,59.6,2974,54.4,284,5.2,189,3.5,139,2.5,50,0.9,2016,36.9
E02000063,6083,100,3570,58.7,3308,54.4,262,4.3,180,3,123,2,57,0.9,2333,38.4
E02000064,5335,100,3315,62.1,3091,57.9,224,4.2,150,2.8,101,1.9,49,0.9,1870,35.1
E02006953,7511,100,4899,65.2,4527,60.3,372,5,379,5,240,3.2,139,1.9,2233,29.7
E02006954,8054,100,5218,64.8,4899,60.8,319,4,311,3.9,239,3,72,0.9,2525,31.4
E02000065,5941,100,3676,61.9,3360,56.6,316,5.3,313,5.3,215,3.6,98,1.6,1952,32.9
E02000066,7250,100,4309,59.4,3933,54.2,376,5.2,258,3.6,204,2.8,54,0.7,2683,37
E02000067,7901,100,5113,64.7,4772,60.4,341,4.3,239,3,188,2.4,51,0.6,2549,32.3
E02000068,6029,100,3757,62.3,3469,57.5,288,4.8,181,3,137,2.3,44,0.7,2091,34.7
E02000069,5673,100,3549,62.6,3367,59.4,182,3.2,121,2.1,92,1.6,29,0.5,2003,35.3
E02000070,6553,100,3934,60,3761,57.4,173,2.6,139,2.1,106,1.6,33,0.5,2480,37.8
E02000071,5985,100,3741,62.5,3515,58.7,226,3.8,127,2.1,89,1.5,38,0.6,2117,35.4
E02000072,9491,100,6050,63.7,5594,58.9,456,4.8,309,3.3,246,2.6,63,0.7,3132,33
E02000073,8703,100,5440,62.5,5209,59.9,231,2.7,187,2.1,135,1.6,52,0.6,3076,35.3
E02000074,6865,100,4229,61.6,3942,57.4,287,4.2,173,2.5,114,1.7,59,0.9,2463,35.9
E02000075,6607,100,3844,58.2,3698,56,146,2.2,95,1.4,62,0.9,33,0.5,2668,40.4
E02000077,6571,100,4063,61.8,3840,58.4,223,3.4,118,1.8,91,1.4,27,0.4,2390,36.4
E02000078,6394,100,4037,63.1,3878,60.7,159,2.5,92,1.4,63,1,29,0.5,2265,35.4
E02000079,7097,100,4438,62.5,4226,59.5,212,3,96,1.4,72,1,24,0.3,2563,36.1
E02000080,8089,100,5095,63,4859,60.1,236,2.9,131,1.6,90,1.1,41,0.5,2863,35.4
E02000081,6618,100,3922,59.3,3746,56.6,176,2.7,119,1.8,101,1.5,18,0.3,2577,38.9
E02000082,7458,100,4917,65.9,4736,63.5,181,2.4,151,2,117,1.6,34,0.5,2390,32
E02000083,8883,100,5778,65,5495,61.9,283,3.2,201,2.3,137,1.5,64,0.7,2904,32.7
E02000084,8932,100,5638,63.1,5409,60.6,229,2.6,124,1.4,97,1.1,27,0.3,3170,35.5
E02000085,6379,100,4113,64.5,3958,62,155,2.4,91,1.4,66,1,25,0.4,2175,34.1
E02000086,5851,100,3668,62.7,3548,60.6,120,2.1,79,1.4,69,1.2,10,0.2,2104,36
E02000087,6722,100,4070,60.5,3911,58.2,159,2.4,105,1.6,74,1.1,31,0.5,2547,37.9
E02000088,6273,100,3948,62.9,3833,61.1,115,1.8,80,1.3,54,0.9,26,0.4,2245,35.8
E02000089,6352,100,3798,59.8,3649,57.4,149,2.3,131,2.1,98,1.5,33,0.5,2423,38.1
E02000090,8110,100,4814,59.4,4586,56.5,228,2.8,192,2.4,135,1.7,57,0.7,3104,38.3
E02000091,8415,100,4874,57.9,4642,55.2,232,2.8,148,1.8,110,1.3,38,0.5,3393,40.3
E02000092,5295,100,3064,57.9,2857,54,207,3.9,85,1.6,63,1.2,22,0.4,2146,40.5
E02006785,5400,100,3300,61.1,3101,57.4,199,3.7,91,1.7,63,1.2,28,0.5,2009,37.2
E02000093,9785,100,6095,62.3,5738,58.6,357,3.6,314,3.2,245,2.5,69,0.7,3376,34.5
E02000094,8459,100,5227,61.8,4885,57.7,342,4,284,3.4,213,2.5,71,0.8,2948,34.9
E02000095,8595,100,5225,60.8,4899,57,326,3.8,275,3.2,213,2.5,62,0.7,3095,36
E02000096,6275,100,3737,59.6,3558,56.7,179,2.9,147,2.3,120,1.9,27,0.4,2391,38.1
E02000097,7762,100,4643,59.8,4351,56.1,292,3.8,253,3.3,215,2.8,38,0.5,2866,36.9
E02000098,7156,100,3999,55.9,3734,52.2,265,3.7,199,2.8,149,2.1,50,0.7,2958,41.3
E02000099,7543,100,4718,62.5,4434,58.8,284,3.8,315,4.2,277,3.7,38,0.5,2510,33.3
E02000100,7182,100,4255,59.2,4012,55.9,243,3.4,325,4.5,199,2.8,126,1.8,2602,36.2
E02000101,7933,100,4473,56.4,4117,51.9,356,4.5,273,3.4,174,2.2,99,1.2,3187,40.2
E02000102,6225,100,3348,53.8,3089,49.6,259,4.2,196,3.1,135,2.2,61,1,2681,43.1
E02000103,7852,100,4518,57.5,4097,52.2,421,5.4,215,2.7,157,2,58,0.7,3119,39.7
E02000104,6267,100,3677,58.7,3439,54.9,238,3.8,187,3,147,2.3,40,0.6,2403,38.3
E02000105,7854,100,4707,59.9,4401,56,306,3.9,270,3.4,211,2.7,59,0.8,2877,36.6
E02000106,8260,100,4745,57.4,4268,51.7,477,5.8,296,3.6,219,2.7,77,0.9,3219,39
E02000107,9061,100,5762,63.6,5369,59.3,393,4.3,204,2.3,154,1.7,50,0.6,3095,34.2
E02000108,5857,100,3574,61,3346,57.1,228,3.9,218,3.7,167,2.9,51,0.9,2065,35.3
E02000110,6769,100,4150,61.3,3815,56.4,335,4.9,193,2.9,157,2.3,36,0.5,2426,35.8
E02000111,9035,100,5472,60.6,5107,56.5,365,4,248,2.7,200,2.2,48,0.5,3315,36.7
E02000112,9703,100,6297,64.9,5836,60.1,461,4.8,310,3.2,250,2.6,60,0.6,3096,31.9
E02000113,7431,100,3768,50.7,3272,44,496,6.7,256,3.4,174,2.3,82,1.1,3407,45.8
E02000114,7595,100,4975,65.5,4626,60.9,349,4.6,238,3.1,171,2.3,67,0.9,2382,31.4
E02000115,7288,100,4672,64.1,4339,59.5,333,4.6,141,1.9,95,1.3,46,0.6,2475,34
E02000116,6673,100,3947,59.1,3577,53.6,370,5.5,195,2.9,142,2.1,53,0.8,2531,37.9
E02000117,9681,100,5449,56.3,4839,50,610,6.3,259,2.7,180,1.9,79,0.8,3973,41
E02000118,9246,100,5791,62.6,5429,58.7,362,3.9,283,3.1,216,2.3,67,0.7,3172,34.3
E02000119,8172,100,4694,57.4,4233,51.8,461,5.6,285,3.5,187,2.3,98,1.2,3193,39.1
E02000120,7612,100,5253,69,4868,64,385,5.1,228,3,184,2.4,44,0.6,2131,28
E02000121,9846,100,6083,61.8,5684,57.7,399,4.1,282,2.9,209,2.1,73,0.7,3481,35.4
E02000122,6688,100,4312,64.5,4001,59.8,311,4.7,140,2.1,90,1.3,50,0.7,2236,33.4
E02000123,10787,100,6611,61.3,5995,55.6,616,5.7,287,2.7,214,2,73,0.7,3889,36.1
E02000124,8113,100,5504,67.8,5177,63.8,327,4,149,1.8,126,1.6,23,0.3,2460,30.3
E02000125,8064,100,5472,67.9,5115,63.4,357,4.4,135,1.7,109,1.4,26,0.3,2457,30.5
E02000126,6574,100,4049,61.6,3611,54.9,438,6.7,235,3.6,152,2.3,83,1.3,2290,34.8
E02006955,6412,100,3814,59.5,3560,55.5,254,4,565,8.8,283,4.4,282,4.4,2033,31.7
E02006956,7383,100,4024,54.5,3732,50.5,292,4,533,7.2,307,4.2,226,3.1,2826,38.3
E02000127,7223,100,4496,62.2,4176,57.8,320,4.4,114,1.6,86,1.2,28,0.4,2613,36.2
E02000128,6104,100,3866,63.3,3683,60.3,183,3,78,1.3,61,1,17,0.3,2160,35.4
E02000130,6822,100,4741,69.5,4476,65.6,265,3.9,99,1.5,83,1.2,16,0.2,1982,29.1
E02000131,8633,100,6542,75.8,6138,71.1,404,4.7,130,1.5,100,1.2,30,0.3,1961,22.7
E02000132,8230,100,5757,70,5437,66.1,320,3.9,131,1.6,98,1.2,33,0.4,2342,28.5
E02000133,8697,100,5293,60.9,5122,58.9,171,2,108,1.2,84,1,24,0.3,3296,37.9
E02000134,9439,100,6343,67.2,5990,63.5,353,3.7,190,2,152,1.6,38,0.4,2906,30.8
E02000135,7976,100,5121,64.2,4730,59.3,391,4.9,159,2,139,1.7,20,0.3,2696,33.8
E02000136,4651,100,2591,55.7,2438,52.4,153,3.3,73,1.6,58,1.2,15,0.3,1987,42.7
E02000137,6824,100,4345,63.7,4166,61,179,2.6,111,1.6,87,1.3,24,0.4,2368,34.7
E02000138,7235,100,4499,62.2,4294,59.4,205,2.8,88,1.2,79,1.1,9,0.1,2648,36.6
E02000139,6142,100,4272,69.6,4097,66.7,175,2.8,73,1.2,44,0.7,29,0.5,1797,29.3
E02000140,6590,100,4007,60.8,3737,56.7,270,4.1,117,1.8,79,1.2,38,0.6,2466,37.4
E02000141,5824,100,4089,70.2,3826,65.7,263,4.5,99,1.7,85,1.5,14,0.2,1636,28.1
E02000142,7007,100,4520,64.5,4332,61.8,188,2.7,108,1.5,82,1.2,26,0.4,2379,34
E02000144,8106,100,5663,69.9,5403,66.7,260,3.2,125,1.5,99,1.2,26,0.3,2318,28.6
E02000145,6676,100,4067,60.9,3827,57.3,240,3.6,142,2.1,111,1.7,31,0.5,2467,37
E02000146,7730,100,5286,68.4,5064,65.5,222,2.9,123,1.6,89,1.2,34,0.4,2321,30
E02000147,6563,100,3832,58.4,3704,56.4,128,2,90,1.4,65,1,25,0.4,2641,40.2
E02000148,5408,100,3217,59.5,3086,57.1,131,2.4,60,1.1,47,0.9,13,0.2,2131,39.4
E02000149,6498,100,4119,63.4,3900,60,219,3.4,107,1.6,82,1.3,25,0.4,2272,35
E02000150,6742,100,4308,63.9,4094,60.7,214,3.2,108,1.6,75,1.1,33,0.5,2326,34.5
E02000151,6005,100,3569,59.4,3469,57.8,100,1.7,64,1.1,40,0.7,24,0.4,2372,39.5
E02000152,6131,100,3881,63.3,3672,59.9,209,3.4,104,1.7,71,1.2,33,0.5,2146,35
E02000153,6376,100,4009,62.9,3865,60.6,144,2.3,112,1.8,78,1.2,34,0.5,2255,35.4
E02000154,6979,100,4342,62.2,4150,59.5,192,2.8,104,1.5,78,1.1,26,0.4,2533,36.3
E02000155,5971,100,3379,56.6,3231,54.1,148,2.5,72,1.2,51,0.9,21,0.4,2520,42.2
E02000156,10073,100,5900,58.6,5692,56.5,208,2.1,123,1.2,92,0.9,31,0.3,4050,40.2
E02000157,6747,100,3979,59,3827,56.7,152,2.3,131,1.9,92,1.4,39,0.6,2637,39.1
E02000158,6128,100,3505,57.2,3303,53.9,202,3.3,100,1.6,69,1.1,31,0.5,2523,41.2
E02000159,5906,100,3436,58.2,3296,55.8,140,2.4,79,1.3,56,0.9,23,0.4,2391,40.5
E02000160,6536,100,3914,59.9,3735,57.1,179,2.7,104,1.6,72,1.1,32,0.5,2518,38.5
E02000161,6917,100,4239,61.3,4080,59,159,2.3,93,1.3,66,1,27,0.4,2585,37.4
E02000162,5789,100,3252,56.2,3088,53.3,164,2.8,88,1.5,63,1.1,25,0.4,2449,42.3
E02000163,6301,100,3743,59.4,3619,57.4,124,2,94,1.5,73,1.2,21,0.3,2464,39.1
E02000165,5782,100,3798,65.7,3668,63.4,130,2.2,81,1.4,54,0.9,27,0.5,1903,32.9
E02006782,6503,100,3968,61,3768,57.9,200,3.1,131,2,108,1.7,23,0.4,2404,37
E02006787,6149,100,4039,65.7,3876,63,163,2.7,80,1.3,66,1.1,14,0.2,2030,33
E02006789,5672,100,3105,54.7,2995,52.8,110,1.9,70,1.2,57,1,13,0.2,2497,44
E02000166,6528,100,3856,59.1,3589,55,267,4.1,116,1.8,81,1.2,35,0.5,2556,39.2
E02000167,6002,100,3915,65.2,3765,62.7,150,2.5,77,1.3,62,1,15,0.2,2010,33.5
E02000168,6620,100,4489,67.8,4248,64.2,241,3.6,119,1.8,88,1.3,31,0.5,2012,30.4
E02000169,5757,100,3652,63.4,3503,60.8,149,2.6,90,1.6,70,1.2,20,0.3,2015,35
E02000170,6576,100,4549,69.2,4340,66,209,3.2,136,2.1,106,1.6,30,0.5,1891,28.8
E02000171,6213,100,4105,66.1,3878,62.4,227,3.7,113,1.8,85,1.4,28,0.5,1995,32.1
E02000172,8167,100,4553,55.7,4145,50.8,408,5,248,3,169,2.1,79,1,3366,41.2
E02000173,6179,100,4234,68.5,4045,65.5,189,3.1,119,1.9,79,1.3,40,0.6,1826,29.6
E02000174,6759,100,4215,62.4,3935,58.2,280,4.1,203,3,137,2,66,1,2341,34.6
E02000175,7882,100,5448,69.1,5166,65.5,282,3.6,246,3.1,163,2.1,83,1.1,2188,27.8
E02000176,4969,100,3527,71,3400,68.4,127,2.6,84,1.7,64,1.3,20,0.4,1358,27.3
E02000177,7099,100,4211,59.3,3880,54.7,331,4.7,230,3.2,164,2.3,66,0.9,2658,37.4
E02000178,7610,100,5015,65.9,4682,61.5,333,4.4,193,2.5,143,1.9,50,0.7,2402,31.6
E02000179,4721,100,2950,62.5,2778,58.8,172,3.6,112,2.4,77,1.6,35,0.7,1659,35.1
E02000180,6741,100,4184,62.1,3856,57.2,328,4.9,277,4.1,202,3,75,1.1,2280,33.8
E02000181,6841,100,4973,72.7,4745,69.4,228,3.3,131,1.9,95,1.4,36,0.5,1737,25.4
E02000182,5786,100,3482,60.2,3286,56.8,196,3.4,157,2.7,107,1.8,50,0.9,2147,37.1
E02000183,6445,100,3933,61,3721,57.7,212,3.3,164,2.5,125,1.9,39,0.6,2348,36.4
E02000184,7749,100,4042,52.2,3652,47.1,390,5,424,5.5,295,3.8,129,1.7,3283,42.4
E02000185,7264,100,4146,57.1,3760,51.8,386,5.3,201,2.8,143,2,58,0.8,2917,40.2
E02000186,5432,100,3174,58.4,2957,54.4,217,4,249,4.6,149,2.7,100,1.8,2009,37
E02000187,7986,100,3749,46.9,3341,41.8,408,5.1,414,5.2,264,3.3,150,1.9,3823,47.9
E02000188,5928,100,2807,47.4,2488,42,319,5.4,295,5,198,3.3,97,1.6,2826,47.7
E02000191,5025,100,2044,40.7,1936,38.5,108,2.1,361,7.2,208,4.1,153,3,2620,52.1
E02000192,5740,100,3273,57,2994,52.2,279,4.9,198,3.4,152,2.6,46,0.8,2269,39.5
E02000193,5502,100,2840,51.6,2645,48.1,195,3.5,275,5,179,3.3,96,1.7,2387,43.4
E02007115,10384,100,4150,40,3694,35.6,456,4.4,772,7.4,471,4.5,301,2.9,5462,52.6
E02000194,7484,100,5208,69.6,4891,65.4,317,4.2,148,2,113,1.5,35,0.5,2128,28.4
E02000195,7739,100,4772,61.7,4462,57.7,310,4,178,2.3,123,1.6,55,0.7,2789,36
E02000196,6478,100,3916,60.5,3631,56.1,285,4.4,150,2.3,121,1.9,29,0.4,2412,37.2
E02000197,7318,100,4647,63.5,4320,59,327,4.5,190,2.6,140,1.9,50,0.7,2481,33.9
E02000198,7014,100,4557,65,4138,59,419,6,181,2.6,130,1.9,51,0.7,2276,32.4
E02000199,6748,100,4429,65.6,4102,60.8,327,4.8,194,2.9,148,2.2,46,0.7,2125,31.5
E02000200,7350,100,4934,67.1,4608,62.7,326,4.4,169,2.3,128,1.7,41,0.6,2247,30.6
E02000201,6783,100,4479,66,4083,60.2,396,5.8,152,2.2,109,1.6,43,0.6,2152,31.7
E02000202,7146,100,4309,60.3,3970,55.6,339,4.7,195,2.7,150,2.1,45,0.6,2642,37
E02000203,6297,100,3867,61.4,3574,56.8,293,4.7,183,2.9,147,2.3,36,0.6,2247,35.7
E02000204,7611,100,4552,59.8,4156,54.6,396,5.2,232,3,184,2.4,48,0.6,2827,37.1
E02000206,8346,100,5433,65.1,4929,59.1,504,6,224,2.7,179,2.1,45,0.5,2689,32.2
E02000207,7211,100,4620,64.1,4234,58.7,386,5.4,207,2.9,127,1.8,80,1.1,2384,33.1
E02000208,8127,100,4908,60.4,4495,55.3,413,5.1,283,3.5,219,2.7,64,0.8,2936,36.1
E02000209,6996,100,4296,61.4,4029,57.6,267,3.8,254,3.6,202,2.9,52,0.7,2446,35
E02000210,6945,100,4699,67.7,4443,64,256,3.7,196,2.8,140,2,56,0.8,2050,29.5
E02000211,6825,100,4201,61.6,4002,58.6,199,2.9,101,1.5,76,1.1,25,0.4,2523,37
E02000212,7205,100,4395,61,4019,55.8,376,5.2,283,3.9,206,2.9,77,1.1,2527,35.1
E02000213,9888,100,6337,64.1,5750,58.2,587,5.9,341,3.4,247,2.5,94,1,3210,32.5
E02000214,5088,100,3195,62.8,3027,59.5,168,3.3,102,2,70,1.4,32,0.6,1791,35.2
E02000215,9622,100,6428,66.8,6030,62.7,398,4.1,288,3,232,2.4,56,0.6,2906,30.2
E02000216,5751,100,3595,62.5,3385,58.9,210,3.7,117,2,84,1.5,33,0.6,2039,35.5
E02000217,9309,100,6450,69.3,6031,64.8,419,4.5,238,2.6,169,1.8,69,0.7,2621,28.2
E02000218,5128,100,2944,57.4,2705,52.7,239,4.7,128,2.5,91,1.8,37,0.7,2056,40.1
E02000219,6508,100,3713,57.1,3564,54.8,149,2.3,109,1.7,83,1.3,26,0.4,2686,41.3
E02000221,8359,100,5235,62.6,4812,57.6,423,5.1,244,2.9,177,2.1,67,0.8,2880,34.5
E02000222,6725,100,4649,69.1,4410,65.6,239,3.6,116,1.7,82,1.2,34,0.5,1960,29.1
E02000223,6014,100,3395,56.5,3068,51,327,5.4,220,3.7,135,2.2,85,1.4,2399,39.9
E02000224,6402,100,4484,70,4249,66.4,235,3.7,141,2.2,104,1.6,37,0.6,1777,27.8
E02000225,5829,100,3496,60,3259,55.9,237,4.1,165,2.8,124,2.1,41,0.7,2168,37.2
E02000226,6284,100,3658,58.2,3502,55.7,156,2.5,80,1.3,49,0.8,31,0.5,2546,40.5
E02000227,9380,100,5924,63.2,5616,59.9,308,3.3,128,1.4,103,1.1,25,0.3,3328,35.5
E02000228,6394,100,3733,58.4,3600,56.3,133,2.1,72,1.1,54,0.8,18,0.3,2589,40.5
E02000229,4726,100,2652,56.1,2459,52,193,4.1,104,2.2,81,1.7,23,0.5,1970,41.7
E02000230,8573,100,5244,61.2,4976,58,268,3.1,141,1.6,104,1.2,37,0.4,3188,37.2
E02000231,6541,100,3942,60.3,3785,57.9,157,2.4,93,1.4,69,1.1,24,0.4,2506,38.3
E02000232,5074,100,2980,58.7,2853,56.2,127,2.5,70,1.4,50,1,20,0.4,2024,39.9
E02000233,4998,100,3235,64.7,3102,62.1,133,2.7,99,2,74,1.5,25,0.5,1664,33.3
E02000234,7422,100,4727,63.7,4486,60.4,241,3.2,122,1.6,80,1.1,42,0.6,2573,34.7
E02000235,5608,100,3530,62.9,3394,60.5,136,2.4,74,1.3,58,1,16,0.3,2004,35.7
E02000236,7068,100,4775,67.6,4587,64.9,188,2.7,104,1.5,76,1.1,28,0.4,2189,31
E02000237,6120,100,3617,59.1,3461,56.6,156,2.5,82,1.3,49,0.8,33,0.5,2421,39.6
E02006788,5927,100,3857,65.1,3587,60.5,270,4.6,154,2.6,103,1.7,51,0.9,1916,32.3
E02006987,6327,100,4898,77.4,4581,72.4,317,5,172,2.7,139,2.2,33,0.5,1257,19.9
E02006988,5714,100,3898,68.2,3636,63.6,262,4.6,104,1.8,81,1.4,23,0.4,1712,30
E02000238,8612,100,5684,66,5333,61.9,351,4.1,224,2.6,176,2,48,0.6,2704,31.4
E02000239,7457,100,4693,62.9,4441,59.6,252,3.4,183,2.5,145,1.9,38,0.5,2581,34.6
E02000240,8734,100,5157,59,4773,54.6,384,4.4,232,2.7,153,1.8,79,0.9,3345,38.3
E02000241,5908,100,3726,63.1,3456,58.5,270,4.6,167,2.8,122,2.1,45,0.8,2015,34.1
E02000242,5642,100,3441,61,3203,56.8,238,4.2,133,2.4,83,1.5,50,0.9,2068,36.7
E02000243,7115,100,4325,60.8,4040,56.8,285,4,164,2.3,117,1.6,47,0.7,2626,36.9
E02000244,6389,100,3962,62,3675,57.5,287,4.5,134,2.1,99,1.5,35,0.5,2293,35.9
E02000245,6940,100,4067,58.6,3770,54.3,297,4.3,216,3.1,153,2.2,63,0.9,2657,38.3
E02000246,7196,100,4272,59.4,3921,54.5,351,4.9,210,2.9,150,2.1,60,0.8,2714,37.7
E02000247,8643,100,5078,58.8,4652,53.8,426,4.9,222,2.6,165,1.9,57,0.7,3343,38.7
E02000248,6140,100,3846,62.6,3592,58.5,254,4.1,151,2.5,123,2,28,0.5,2143,34.9
E02000249,6680,100,4005,60,3726,55.8,279,4.2,185,2.8,137,2.1,48,0.7,2490,37.3
E02000250,5208,100,3263,62.7,3115,59.8,148,2.8,63,1.2,50,1,13,0.2,1882,36.1
E02000251,6649,100,3996,60.1,3730,56.1,266,4,171,2.6,123,1.8,48,0.7,2482,37.3
E02000252,10467,100,5467,52.2,5034,48.1,433,4.1,696,6.6,380,3.6,316,3,4304,41.1
E02000253,8048,100,4512,56.1,4117,51.2,395,4.9,178,2.2,130,1.6,48,0.6,3358,41.7
E02000254,7488,100,4203,56.1,3869,51.7,334,4.5,168,2.2,130,1.7,38,0.5,3117,41.6
E02000255,7879,100,4817,61.1,4463,56.6,354,4.5,193,2.4,124,1.6,69,0.9,2869,36.4
E02000256,7782,100,5364,68.9,5082,65.3,282,3.6,162,2.1,117,1.5,45,0.6,2256,29
E02000258,5482,100,3539,64.6,3294,60.1,245,4.5,139,2.5,93,1.7,46,0.8,1804,32.9
E02000259,5156,100,3440,66.7,3243,62.9,197,3.8,88,1.7,65,1.3,23,0.4,1628,31.6
E02000260,7832,100,4052,51.7,3645,46.5,407,5.2,242,3.1,165,2.1,77,1,3538,45.2
E02000261,10375,100,6858,66.1,6300,60.7,558,5.4,285,2.7,211,2,74,0.7,3232,31.2
E02000262,7591,100,5046,66.5,4709,62,337,4.4,229,3,174,2.3,55,0.7,2316,30.5
E02000263,10844,100,5891,54.3,5311,49,580,5.3,303,2.8,211,1.9,92,0.8,4650,42.9
E02000264,7291,100,4777,65.5,4457,61.1,320,4.4,234,3.2,204,2.8,30,0.4,2280,31.3
E02000265,9081,100,5888,64.8,5406,59.5,482,5.3,193,2.1,125,1.4,68,0.7,3000,33
E02000266,10326,100,5800,56.2,5261,50.9,539,5.2,300,2.9,203,2,97,0.9,4226,40.9
E02000267,6420,100,4362,67.9,4099,63.8,263,4.1,123,1.9,88,1.4,35,0.5,1935,30.1
E02000268,7799,100,5042,64.6,4735,60.7,307,3.9,202,2.6,140,1.8,62,0.8,2555,32.8
E02000269,6595,100,4584,69.5,4347,65.9,237,3.6,114,1.7,84,1.3,30,0.5,1897,28.8
E02000270,7769,100,5298,68.2,4928,63.4,370,4.8,191,2.5,131,1.7,60,0.8,2280,29.3
E02000271,5636,100,3860,68.5,3683,65.3,177,3.1,86,1.5,49,0.9,37,0.7,1690,30
E02000272,5361,100,3449,64.3,3282,61.2,167,3.1,91,1.7,63,1.2,28,0.5,1821,34
E02000275,6561,100,3569,54.4,3286,50.1,283,4.3,149,2.3,105,1.6,44,0.7,2843,43.3
E02000276,5421,100,3767,69.5,3567,65.8,200,3.7,133,2.5,96,1.8,37,0.7,1521,28.1
E02006791,6324,100,4537,71.7,4296,67.9,241,3.8,101,1.6,68,1.1,33,0.5,1686,26.7
E02006968,6878,100,4340,63.1,4076,59.3,264,3.8,154,2.2,120,1.7,34,0.5,2384,34.7
E02006969,5480,100,3812,69.6,3600,65.7,212,3.9,139,2.5,103,1.9,36,0.7,1529,27.9
E02006970,5660,100,3262,57.6,2919,51.6,343,6.1,157,2.8,104,1.8,53,0.9,2241,39.6
E02006971,6501,100,3541,54.5,3181,48.9,360,5.5,190,2.9,129,2,61,0.9,2770,42.6
E02000277,5728,100,3186,55.6,2963,51.7,223,3.9,203,3.5,126,2.2,77,1.3,2339,40.8
E02000278,7152,100,3692,51.6,3384,47.3,308,4.3,214,3,142,2,72,1,3246,45.4
E02000279,9083,100,5377,59.2,4942,54.4,435,4.8,291,3.2,189,2.1,102,1.1,3415,37.6
E02000280,6737,100,4082,60.6,3870,57.4,212,3.1,133,2,92,1.4,41,0.6,2522,37.4
E02000281,7376,100,4429,60,4132,56,297,4,168,2.3,105,1.4,63,0.9,2779,37.7
E02000282,7164,100,3691,51.5,3314,46.3,377,5.3,236,3.3,163,2.3,73,1,3237,45.2
E02000283,6497,100,3684,56.7,3366,51.8,318,4.9,177,2.7,124,1.9,53,0.8,2636,40.6
E02000284,6915,100,4388,63.5,4162,60.2,226,3.3,97,1.4,70,1,27,0.4,2430,35.1
E02000285,5372,100,3300,61.4,3167,59,133,2.5,80,1.5,61,1.1,19,0.4,1992,37.1
E02000286,7074,100,4304,60.8,4127,58.3,177,2.5,86,1.2,65,0.9,21,0.3,2684,37.9
E02000287,6019,100,3510,58.3,3361,55.8,149,2.5,68,1.1,63,1,5,0.1,2441,40.6
E02000288,9493,100,5098,53.7,4694,49.4,404,4.3,306,3.2,203,2.1,103,1.1,4089,43.1
E02000289,5468,100,3292,60.2,3136,57.4,156,2.9,90,1.6,63,1.2,27,0.5,2086,38.1
E02000290,4855,100,2690,55.4,2439,50.2,251,5.2,144,3,98,2,46,0.9,2021,41.6
E02000291,8044,100,4823,60,4474,55.6,349,4.3,178,2.2,137,1.7,41,0.5,3043,37.8
E02000292,7612,100,4625,60.8,4340,57,285,3.7,168,2.2,133,1.7,35,0.5,2819,37
E02000293,5222,100,3008,57.6,2879,55.1,129,2.5,56,1.1,39,0.7,17,0.3,2158,41.3
E02000294,7184,100,3880,54,3539,49.3,341,4.7,175,2.4,128,1.8,47,0.7,3129,43.6
E02000295,6887,100,4115,59.8,3891,56.5,224,3.3,97,1.4,78,1.1,19,0.3,2675,38.8
E02000296,8270,100,4960,60,4636,56.1,324,3.9,193,2.3,147,1.8,46,0.6,3117,37.7
E02000297,7736,100,4620,59.7,4391,56.8,229,3,141,1.8,122,1.6,19,0.2,2975,38.5
E02000298,6674,100,4293,64.3,4113,61.6,180,2.7,60,0.9,46,0.7,14,0.2,2321,34.8
E02000299,7143,100,3874,54.2,3536,49.5,338,4.7,208,2.9,159,2.2,49,0.7,3061,42.9
E02000300,6738,100,3662,54.3,3388,50.3,274,4.1,252,3.7,214,3.2,38,0.6,2824,41.9
E02000301,7750,100,4154,53.6,3782,48.8,372,4.8,243,3.1,190,2.5,53,0.7,3353,43.3
E02000302,6994,100,4192,59.9,3931,56.2,261,3.7,119,1.7,94,1.3,25,0.4,2683,38.4
E02000303,6476,100,3356,51.8,3069,47.4,287,4.4,210,3.2,148,2.3,62,1,2910,44.9
E02000304,6550,100,4003,61.1,3800,58,203,3.1,87,1.3,71,1.1,16,0.2,2460,37.6
E02000305,7311,100,4842,66.2,4555,62.3,287,3.9,153,2.1,128,1.8,25,0.3,2316,31.7
E02000306,6840,100,3547,51.9,3171,46.4,376,5.5,187,2.7,120,1.8,67,1,3106,45.4
E02000307,7820,100,4640,59.3,4332,55.4,308,3.9,176,2.3,133,1.7,43,0.5,3004,38.4
E02000308,7045,100,4477,63.5,4205,59.7,272,3.9,210,3,147,2.1,63,0.9,2358,33.5
E02000309,8798,100,4949,56.3,4523,51.4,426,4.8,288,3.3,204,2.3,84,1,3561,40.5
E02000311,8515,100,5094,59.8,4577,53.8,517,6.1,209,2.5,158,1.9,51,0.6,3212,37.7
E02000312,9318,100,6129,65.8,5709,61.3,420,4.5,228,2.4,194,2.1,34,0.4,2961,31.8
E02006793,7324,100,3896,53.2,3447,47.1,449,6.1,222,3,166,2.3,56,0.8,3206,43.8
E02000313,4862,100,2974,61.2,2667,54.9,307,6.3,181,3.7,138,2.8,43,0.9,1707,35.1
E02000314,10650,100,6457,60.6,5736,53.9,721,6.8,390,3.7,317,3,73,0.7,3803,35.7
E02000315,7288,100,4346,59.6,3999,54.9,347,4.8,234,3.2,179,2.5,55,0.8,2708,37.2
E02000317,5792,100,3448,59.5,3113,53.7,335,5.8,211,3.6,159,2.7,52,0.9,2133,36.8
E02000318,8719,100,5078,58.2,4648,53.3,430,4.9,385,4.4,323,3.7,62,0.7,3256,37.3
E02000319,8330,100,5387,64.7,4914,59,473,5.7,250,3,206,2.5,44,0.5,2693,32.3
E02000320,5477,100,3441,62.8,3147,57.5,294,5.4,171,3.1,134,2.4,37,0.7,1865,34.1
E02000321,5983,100,3697,61.8,3323,55.5,374,6.3,208,3.5,139,2.3,69,1.2,2078,34.7
E02000323,9960,100,6386,64.1,5843,58.7,543,5.5,413,4.1,287,2.9,126,1.3,3161,31.7
E02000324,6119,100,3670,60,3367,55,303,5,176,2.9,130,2.1,46,0.8,2273,37.1
E02000326,6275,100,4477,71.3,4245,67.6,232,3.7,134,2.1,96,1.5,38,0.6,1664,26.5
E02000327,5133,100,3278,63.9,2942,57.3,336,6.5,149,2.9,100,1.9,49,1,1706,33.2
E02000328,5351,100,3595,67.2,3429,64.1,166,3.1,79,1.5,55,1,24,0.4,1677,31.3
E02000329,5033,100,3079,61.2,2885,57.3,194,3.9,118,2.3,83,1.6,35,0.7,1836,36.5
E02000331,6483,100,4057,62.6,3737,57.6,320,4.9,153,2.4,124,1.9,29,0.4,2273,35.1
E02000332,5924,100,3800,64.1,3573,60.3,227,3.8,140,2.4,121,2,19,0.3,1984,33.5
E02000333,5124,100,3417,66.7,3258,63.6,159,3.1,85,1.7,59,1.2,26,0.5,1622,31.7
E02000334,5322,100,3325,62.5,3105,58.3,220,4.1,112,2.1,78,1.5,34,0.6,1885,35.4
E02000335,5287,100,3429,64.9,3256,61.6,173,3.3,69,1.3,44,0.8,25,0.5,1789,33.8
E02000337,6646,100,4045,60.9,3743,56.3,302,4.5,142,2.1,109,1.6,33,0.5,2459,37
E02000339,5083,100,3075,60.5,2910,57.2,165,3.2,81,1.6,64,1.3,17,0.3,1927,37.9
E02000340,5613,100,3463,61.7,3267,58.2,196,3.5,101,1.8,83,1.5,18,0.3,2049,36.5
E02000341,6044,100,3608,59.7,3337,55.2,271,4.5,118,2,92,1.5,26,0.4,2318,38.4
E02000342,5107,100,2919,57.2,2728,53.4,191,3.7,263,5.1,167,3.3,96,1.9,1925,37.7
E02000343,5601,100,3366,60.1,3138,56,228,4.1,111,2,69,1.2,42,0.7,2124,37.9
E02000344,5172,100,3213,62.1,3043,58.8,170,3.3,83,1.6,57,1.1,26,0.5,1876,36.3
E02006786,5863,100,3636,62,3358,57.3,278,4.7,160,2.7,125,2.1,35,0.6,2067,35.3
E02006927,9907,100,6532,65.9,6152,62.1,380,3.8,194,2,140,1.4,54,0.5,3181,32.1
E02006928,10281,100,6980,67.9,6603,64.2,377,3.7,608,5.9,370,3.6,238,2.3,2693,26.2
E02006930,8120,100,6044,74.4,5719,70.4,325,4,287,3.5,234,2.9,53,0.7,1789,22
E02006931,7856,100,5320,67.7,5055,64.3,265,3.4,253,3.2,171,2.2,82,1,2283,29.1
E02006991,5634,100,4571,81.1,4325,76.8,246,4.4,148,2.6,102,1.8,46,0.8,915,16.2
E02006992,6793,100,5003,73.6,4748,69.9,255,3.8,194,2.9,132,1.9,62,0.9,1596,23.5
E02006993,6850,100,5067,74,4814,70.3,253,3.7,306,4.5,204,3,102,1.5,1477,21.6
E02006994,6056,100,4022,66.4,3701,61.1,321,5.3,274,4.5,203,3.4,71,1.2,1760,29.1
E02000345,5365,100,3377,62.9,3183,59.3,194,3.6,50,0.9,38,0.7,12,0.2,1938,36.1
E02000346,7514,100,4837,64.4,4418,58.8,419,5.6,183,2.4,122,1.6,61,0.8,2494,33.2
E02000347,5501,100,3340,60.7,3133,57,207,3.8,141,2.6,88,1.6,53,1,2020,36.7
E02000348,5396,100,3178,58.9,2908,53.9,270,5,107,2,63,1.2,44,0.8,2111,39.1
E02000350,8131,100,5720,70.3,5350,65.8,370,4.6,156,1.9,118,1.5,38,0.5,2255,27.7
E02000351,7942,100,5693,71.7,5388,67.8,305,3.8,227,2.9,169,2.1,58,0.7,2022,25.5
E02000352,5264,100,3579,68,3374,64.1,205,3.9,70,1.3,50,0.9,20,0.4,1615,30.7
E02000353,6484,100,4681,72.2,4421,68.2,260,4,133,2.1,95,1.5,38,0.6,1670,25.8
E02000354,8001,100,5189,64.9,4800,60,389,4.9,186,2.3,137,1.7,49,0.6,2626,32.8
E02000355,6786,100,4723,69.6,4393,64.7,330,4.9,146,2.2,106,1.6,40,0.6,1917,28.2
E02000356,5905,100,4404,74.6,4200,71.1,204,3.5,96,1.6,83,1.4,13,0.2,1405,23.8
E02000357,5385,100,3061,56.8,2766,51.4,295,5.5,175,3.2,119,2.2,56,1,2149,39.9
E02000358,9404,100,6625,70.4,6144,65.3,481,5.1,235,2.5,185,2,50,0.5,2544,27.1
E02000359,5388,100,3552,65.9,3302,61.3,250,4.6,109,2,80,1.5,29,0.5,1727,32.1
E02000360,9222,100,5806,63,5307,57.5,499,5.4,262,2.8,185,2,77,0.8,3154,34.2
E02000361,6868,100,4995,72.7,4657,67.8,338,4.9,189,2.8,162,2.4,27,0.4,1684,24.5
E02000362,5815,100,3789,65.2,3454,59.4,335,5.8,140,2.4,85,1.5,55,0.9,1886,32.4
E02000363,9161,100,5464,59.6,4906,53.6,558,6.1,312,3.4,203,2.2,109,1.2,3385,37
E02000364,7783,100,5428,69.7,5049,64.9,379,4.9,156,2,114,1.5,42,0.5,2199,28.3
E02000366,6854,100,4314,62.9,3941,57.5,373,5.4,171,2.5,123,1.8,48,0.7,2369,34.6
E02000367,8898,100,6621,74.4,6228,70,393,4.4,241,2.7,160,1.8,81,0.9,2036,22.9
E02000368,8182,100,5143,62.9,4693,57.4,450,5.5,200,2.4,122,1.5,78,1,2839,34.7
E02000369,11252,100,7864,69.9,7374,65.5,490,4.4,281,2.5,210,1.9,71,0.6,3107,27.6
E02000370,7451,100,4964,66.6,4627,62.1,337,4.5,258,3.5,183,2.5,75,1,2229,29.9
E02006918,6338,100,4139,65.3,3761,59.3,378,6,148,2.3,114,1.8,34,0.5,2051,32.4
E02006921,5551,100,3272,58.9,3020,54.4,252,4.5,115,2.1,92,1.7,23,0.4,2164,39
E02007108,5311,100,4227,79.6,4023,75.7,204,3.8,82,1.5,66,1.2,16,0.3,1002,18.9
E02007109,6485,100,4447,68.6,4151,64,296,4.6,112,1.7,89,1.4,23,0.4,1926,29.7
E02007110,6361,100,4186,65.8,3930,61.8,256,4,258,4.1,171,2.7,87,1.4,1917,30.1
E02007111,5462,100,3952,72.4,3729,68.3,223,4.1,258,4.7,151,2.8,107,2,1252,22.9
E02000372,8514,100,4862,57.1,4428,52,434,5.1,260,3.1,188,2.2,72,0.8,3392,39.8
E02000373,5463,100,3125,57.2,2794,51.1,331,6.1,191,3.5,147,2.7,44,0.8,2147,39.3
E02000374,5627,100,3478,61.8,3221,57.2,257,4.6,192,3.4,119,2.1,73,1.3,1957,34.8
E02000375,6302,100,4108,65.2,3793,60.2,315,5,182,2.9,132,2.1,50,0.8,2012,31.9
E02000376,5833,100,4099,70.3,3796,65.1,303,5.2,129,2.2,102,1.7,27,0.5,1605,27.5
E02000377,6584,100,4335,65.8,4012,60.9,323,4.9,222,3.4,158,2.4,64,1,2027,30.8
E02000378,5581,100,3901,69.9,3630,65,271,4.9,156,2.8,101,1.8,55,1,1524,27.3
E02000379,5968,100,3932,65.9,3687,61.8,245,4.1,106,1.8,78,1.3,28,0.5,1930,32.3
E02000380,4569,100,3136,68.6,2956,64.7,180,3.9,95,2.1,73,1.6,22,0.5,1338,29.3
E02000381,6312,100,4284,67.9,4033,63.9,251,4,127,2,95,1.5,32,0.5,1901,30.1
E02000382,5257,100,3440,65.4,3233,61.5,207,3.9,122,2.3,90,1.7,32,0.6,1695,32.2
E02000383,7525,100,4680,62.2,4342,57.7,338,4.5,255,3.4,204,2.7,51,0.7,2590,34.4
E02000384,7138,100,4467,62.6,4156,58.2,311,4.4,230,3.2,172,2.4,58,0.8,2441,34.2
E02000385,5099,100,3642,71.4,3456,67.8,186,3.6,158,3.1,124,2.4,34,0.7,1299,25.5
E02000386,6443,100,4007,62.2,3655,56.7,352,5.5,234,3.6,174,2.7,60,0.9,2202,34.2
E02000387,5220,100,3295,63.1,3065,58.7,230,4.4,192,3.7,153,2.9,39,0.7,1733,33.2
E02000388,7593,100,5145,67.8,4885,64.3,260,3.4,209,2.8,143,1.9,66,0.9,2239,29.5
E02000389,7309,100,4767,65.2,4544,62.2,223,3.1,199,2.7,148,2,51,0.7,2343,32.1
E02000390,5288,100,3631,68.7,3425,64.8,206,3.9,131,2.5,104,2,27,0.5,1526,28.9
E02000391,6259,100,4208,67.2,3986,63.7,222,3.5,108,1.7,80,1.3,28,0.4,1943,31
E02000392,7693,100,5303,68.9,4995,64.9,308,4,210,2.7,161,2.1,49,0.6,2180,28.3
E02000393,4984,100,3572,71.7,3427,68.8,145,2.9,104,2.1,81,1.6,23,0.5,1308,26.2
E02000394,7723,100,5333,69.1,4968,64.3,365,4.7,153,2,96,1.2,57,0.7,2237,29
E02000395,4876,100,3234,66.3,3115,63.9,119,2.4,82,1.7,65,1.3,17,0.3,1560,32
E02000396,5474,100,3628,66.3,3415,62.4,213,3.9,108,2,84,1.5,24,0.4,1738,31.8
E02000397,6543,100,4376,66.9,4021,61.5,355,5.4,182,2.8,163,2.5,19,0.3,1985,30.3
E02000398,5924,100,3266,55.1,2861,48.3,405,6.8,193,3.3,125,2.1,68,1.1,2465,41.6
E02000400,6356,100,4087,64.3,3784,59.5,303,4.8,161,2.5,114,1.8,47,0.7,2108,33.2
E02000401,5608,100,3123,55.7,2799,49.9,324,5.8,169,3,124,2.2,45,0.8,2316,41.3
E02000402,5187,100,2947,56.8,2654,51.2,293,5.6,150,2.9,98,1.9,52,1,2090,40.3
E02000403,6219,100,4146,66.7,3839,61.7,307,4.9,178,2.9,143,2.3,35,0.6,1895,30.5
E02000404,5907,100,3489,59.1,3178,53.8,311,5.3,224,3.8,188,3.2,36,0.6,2194,37.1
E02000405,4983,100,3393,68.1,3243,65.1,150,3,66,1.3,49,1,17,0.3,1524,30.6
E02000406,5745,100,3683,64.1,3321,57.8,362,6.3,152,2.6,106,1.8,46,0.8,1910,33.2
E02000407,6173,100,3872,62.7,3515,56.9,357,5.8,174,2.8,137,2.2,37,0.6,2127,34.5
E02000408,6476,100,3820,59,3494,54,326,5,185,2.9,137,2.1,48,0.7,2471,38.2
E02000409,5016,100,2971,59.2,2702,53.9,269,5.4,145,2.9,110,2.2,35,0.7,1900,37.9
E02000410,5203,100,3530,67.8,3343,64.3,187,3.6,140,2.7,80,1.5,60,1.2,1533,29.5
E02000411,9370,100,5604,59.8,5174,55.2,430,4.6,600,6.4,411,4.4,189,2,3166,33.8
E02000412,6308,100,3910,62,3585,56.8,325,5.2,231,3.7,194,3.1,37,0.6,2167,34.4
E02000413,6039,100,3928,65,3728,61.7,200,3.3,131,2.2,103,1.7,28,0.5,1980,32.8
E02000414,5846,100,3885,66.5,3592,61.4,293,5,175,3,145,2.5,30,0.5,1786,30.6
E02000415,6067,100,3944,65,3630,59.8,314,5.2,180,3,150,2.5,30,0.5,1943,32
E02000416,7088,100,4888,69,4586,64.7,302,4.3,133,1.9,104,1.5,29,0.4,2067,29.2
E02000417,5441,100,3666,67.4,3471,63.8,195,3.6,89,1.6,61,1.1,28,0.5,1686,31
E02000418,4446,100,2920,65.7,2794,62.8,126,2.8,64,1.4,41,0.9,23,0.5,1462,32.9
E02000419,7401,100,5254,71,4850,65.5,404,5.5,185,2.5,147,2,38,0.5,1962,26.5
E02000420,6764,100,4506,66.6,4121,60.9,385,5.7,194,2.9,152,2.2,42,0.6,2064,30.5
E02000421,7076,100,4281,60.5,3842,54.3,439,6.2,306,4.3,234,3.3,72,1,2489,35.2
E02000422,6022,100,3749,62.3,3426,56.9,323,5.4,170,2.8,136,2.3,34,0.6,2103,34.9
E02000423,5952,100,4122,69.3,3821,64.2,301,5.1,131,2.2,107,1.8,24,0.4,1699,28.5
E02000424,5652,100,4029,71.3,3790,67.1,239,4.2,106,1.9,56,1,50,0.9,1517,26.8
E02000425,5118,100,3271,63.9,3051,59.6,220,4.3,81,1.6,67,1.3,14,0.3,1766,34.5
E02000426,5324,100,3425,64.3,3232,60.7,193,3.6,79,1.5,65,1.2,14,0.3,1820,34.2
E02000427,5779,100,4164,72.1,3881,67.2,283,4.9,163,2.8,136,2.4,27,0.5,1452,25.1
E02000428,6847,100,4534,66.2,4098,59.9,436,6.4,210,3.1,171,2.5,39,0.6,2103,30.7
E02000429,5620,100,3940,70.1,3772,67.1,168,3,73,1.3,43,0.8,30,0.5,1607,28.6
E02000430,5826,100,4406,75.6,4210,72.3,196,3.4,87,1.5,71,1.2,16,0.3,1333,22.9
E02000431,5085,100,3751,73.8,3580,70.4,171,3.4,96,1.9,74,1.5,22,0.4,1238,24.3
E02000432,5333,100,3871,72.6,3639,68.2,232,4.4,123,2.3,104,2,19,0.4,1339,25.1
E02006794,6278,100,3647,58.1,3262,52,385,6.1,224,3.6,152,2.4,72,1.1,2407,38.3
E02000433,7179,100,3987,55.5,3795,52.9,192,2.7,121,1.7,95,1.3,26,0.4,3071,42.8
E02000434,8104,100,5025,62,4761,58.7,264,3.3,174,2.1,142,1.8,32,0.4,2905,35.8
E02000435,6577,100,3712,56.4,3474,52.8,238,3.6,160,2.4,113,1.7,47,0.7,2705,41.1
E02000436,4822,100,2844,59,2721,56.4,123,2.6,76,1.6,65,1.3,11,0.2,1902,39.4
E02000437,7064,100,4093,57.9,3867,54.7,226,3.2,138,2,111,1.6,27,0.4,2833,40.1
E02000438,6696,100,3889,58.1,3668,54.8,221,3.3,121,1.8,89,1.3,32,0.5,2686,40.1
E02000439,7350,100,4517,61.5,4272,58.1,245,3.3,266,3.6,203,2.8,63,0.9,2567,34.9
E02000440,7698,100,4903,63.7,4671,60.7,232,3,152,2,125,1.6,27,0.4,2643,34.3
E02000441,5985,100,3492,58.3,3299,55.1,193,3.2,135,2.3,112,1.9,23,0.4,2358,39.4
E02000442,7698,100,4891,63.5,4594,59.7,297,3.9,281,3.7,216,2.8,65,0.8,2526,32.8
E02000443,8388,100,4958,59.1,4621,55.1,337,4,261,3.1,200,2.4,61,0.7,3169,37.8
E02000444,6906,100,4242,61.4,4023,58.3,219,3.2,164,2.4,137,2,27,0.4,2500,36.2
E02000445,9152,100,5520,60.3,5177,56.6,343,3.7,233,2.5,195,2.1,38,0.4,3399,37.1
E02000447,6472,100,4173,64.5,3961,61.2,212,3.3,126,1.9,94,1.5,32,0.5,2173,33.6
E02000448,5645,100,3341,59.2,3184,56.4,157,2.8,69,1.2,51,0.9,18,0.3,2235,39.6
E02000449,6808,100,4106,60.3,3901,57.3,205,3,218,3.2,183,2.7,35,0.5,2484,36.5
E02000451,5478,100,3348,61.1,3206,58.5,142,2.6,119,2.2,82,1.5,37,0.7,2011,36.7
E02000452,7527,100,4838,64.3,4536,60.3,302,4,256,3.4,198,2.6,58,0.8,2433,32.3
E02000453,6694,100,4383,65.5,4142,61.9,241,3.6,152,2.3,127,1.9,25,0.4,2159,32.3
E02000454,5731,100,3626,63.3,3492,60.9,134,2.3,89,1.6,68,1.2,21,0.4,2016,35.2
E02000455,9515,100,6242,65.6,5836,61.3,406,4.3,313,3.3,247,2.6,66,0.7,2960,31.1
E02000456,6396,100,4110,64.3,3828,59.8,282,4.4,174,2.7,137,2.1,37,0.6,2112,33
E02000457,5775,100,3531,61.1,3335,57.7,196,3.4,103,1.8,86,1.5,17,0.3,2141,37.1
E02000459,7346,100,4580,62.3,4246,57.8,334,4.5,220,3,167,2.3,53,0.7,2546,34.7
E02000460,5673,100,3493,61.6,3231,57,262,4.6,162,2.9,125,2.2,37,0.7,2018,35.6
E02000461,5814,100,3543,60.9,3308,56.9,235,4,157,2.7,121,2.1,36,0.6,2114,36.4
E02000462,5644,100,3385,60,3157,55.9,228,4,198,3.5,148,2.6,50,0.9,2061,36.5
E02000463,6934,100,4093,59,3787,54.6,306,4.4,178,2.6,133,1.9,45,0.6,2663,38.4
E02006795,6608,100,4141,62.7,3905,59.1,236,3.6,187,2.8,156,2.4,31,0.5,2280,34.5
E02006882,11918,100,7218,60.6,6850,57.5,368,3.1,292,2.5,244,2,48,0.4,4408,37
E02000464,6066,100,3653,60.2,3430,56.5,223,3.7,137,2.3,102,1.7,35,0.6,2276,37.5
E02000465,7118,100,4610,64.8,4289,60.3,321,4.5,154,2.2,121,1.7,33,0.5,2354,33.1
E02000466,7132,100,4237,59.4,3947,55.3,290,4.1,126,1.8,91,1.3,35,0.5,2769,38.8
E02000467,8363,100,4961,59.3,4618,55.2,343,4.1,200,2.4,156,1.9,44,0.5,3202,38.3
E02000468,6809,100,4093,60.1,3856,56.6,237,3.5,118,1.7,99,1.5,19,0.3,2598,38.2
E02000469,5586,100,3337,59.7,3137,56.2,200,3.6,121,2.2,98,1.8,23,0.4,2128,38.1
E02000470,8047,100,5135,63.8,4932,61.3,203,2.5,124,1.5,74,0.9,50,0.6,2788,34.6
E02000471,6486,100,3752,57.8,3611,55.7,141,2.2,97,1.5,75,1.2,22,0.3,2637,40.7
E02000472,7573,100,4674,61.7,4436,58.6,238,3.1,141,1.9,108,1.4,33,0.4,2758,36.4
E02000473,8382,100,5388,64.3,5141,61.3,247,2.9,146,1.7,111,1.3,35,0.4,2848,34
E02000474,7207,100,4468,62,4210,58.4,258,3.6,161,2.2,134,1.9,27,0.4,2578,35.8
E02000475,7903,100,4813,60.9,4609,58.3,204,2.6,117,1.5,82,1,35,0.4,2973,37.6
E02000476,7552,100,4898,64.9,4595,60.8,303,4,195,2.6,153,2,42,0.6,2459,32.6
E02000477,7889,100,4923,62.4,4705,59.6,218,2.8,141,1.8,103,1.3,38,0.5,2825,35.8
E02000478,5089,100,2805,55.1,2698,53,107,2.1,55,1.1,40,0.8,15,0.3,2229,43.8
E02000479,7503,100,4916,65.5,4677,62.3,239,3.2,166,2.2,130,1.7,36,0.5,2421,32.3
E02000480,10616,100,6839,64.4,6378,60.1,461,4.3,335,3.2,265,2.5,70,0.7,3442,32.4
E02000481,6657,100,3921,58.9,3768,56.6,153,2.3,95,1.4,65,1,30,0.5,2641,39.7
E02000482,5411,100,3083,57,2979,55.1,104,1.9,69,1.3,43,0.8,26,0.5,2259,41.7
E02000483,6647,100,4015,60.4,3812,57.3,203,3.1,88,1.3,55,0.8,33,0.5,2544,38.3
E02000484,7004,100,4376,62.5,4180,59.7,196,2.8,139,2,113,1.6,26,0.4,2489,35.5
E02000485,6884,100,4385,63.7,4211,61.2,174,2.5,83,1.2,54,0.8,29,0.4,2416,35.1
E02000486,6168,100,3718,60.3,3543,57.4,175,2.8,79,1.3,43,0.7,36,0.6,2371,38.4
E02000487,6597,100,3661,55.5,3572,54.1,89,1.3,82,1.2,59,0.9,23,0.3,2854,43.3
E02000488,6345,100,3844,60.6,3701,58.3,143,2.3,75,1.2,55,0.9,20,0.3,2426,38.2
E02000489,6865,100,4256,62,4029,58.7,227,3.3,126,1.8,95,1.4,31,0.5,2483,36.2
E02000490,6780,100,4131,60.9,3889,57.4,242,3.6,152,2.2,111,1.6,41,0.6,2497,36.8
E02000491,8249,100,5082,61.6,4716,57.2,366,4.4,213,2.6,173,2.1,40,0.5,2954,35.8
E02000492,5629,100,3293,58.5,3132,55.6,161,2.9,89,1.6,73,1.3,16,0.3,2247,39.9
E02000493,5184,100,3253,62.8,3034,58.5,219,4.2,99,1.9,75,1.4,24,0.5,1832,35.3
E02000494,6589,100,3808,57.8,3649,55.4,159,2.4,67,1,49,0.7,18,0.3,2714,41.2
E02000495,8387,100,5199,62,4942,58.9,257,3.1,162,1.9,137,1.6,25,0.3,3026,36.1
E02000496,6384,100,4011,62.8,3813,59.7,198,3.1,76,1.2,46,0.7,30,0.5,2297,36
E02000497,7608,100,4749,62.4,4512,59.3,237,3.1,116,1.5,87,1.1,29,0.4,2743,36.1
E02000498,5178,100,3083,59.5,2945,56.9,138,2.7,60,1.2,41,0.8,19,0.4,2035,39.3
E02000499,6368,100,3808,59.8,3637,57.1,171,2.7,103,1.6,78,1.2,25,0.4,2457,38.6
E02000500,6920,100,4131,59.7,3932,56.8,199,2.9,158,2.3,138,2,20,0.3,2631,38
E02000501,6808,100,4429,65.1,4234,62.2,195,2.9,101,1.5,81,1.2,20,0.3,2278,33.5
E02000502,7027,100,4702,66.9,4504,64.1,198,2.8,135,1.9,98,1.4,37,0.5,2190,31.2
E02000503,6949,100,4756,68.4,4541,65.3,215,3.1,103,1.5,75,1.1,28,0.4,2090,30.1
E02000504,6152,100,3849,62.6,3712,60.3,137,2.2,87,1.4,59,1,28,0.5,2216,36
E02000506,6577,100,3967,60.3,3818,58.1,149,2.3,96,1.5,72,1.1,24,0.4,2514,38.2
E02000507,6402,100,4149,64.8,3916,61.2,233,3.6,145,2.3,101,1.6,44,0.7,2108,32.9
E02000508,9805,100,5512,56.2,5178,52.8,334,3.4,669,6.8,374,3.8,295,3,3624,37
E02000509,8854,100,4113,46.5,3830,43.3,283,3.2,845,9.5,470,5.3,375,4.2,3896,44
E02000510,7315,100,4504,61.6,4231,57.8,273,3.7,199,2.7,155,2.1,44,0.6,2612,35.7
E02000511,7802,100,4839,62,4562,58.5,277,3.6,192,2.5,135,1.7,57,0.7,2771,35.5
E02000512,6813,100,4101,60.2,3789,55.6,312,4.6,171,2.5,121,1.8,50,0.7,2541,37.3
E02000513,7177,100,4227,58.9,3840,53.5,387,5.4,209,2.9,139,1.9,70,1,2741,38.2
E02000514,8232,100,4784,58.1,4403,53.5,381,4.6,260,3.2,163,2,97,1.2,3188,38.7
E02000515,10424,100,6602,63.3,6154,59,448,4.3,331,3.2,210,2,121,1.2,3491,33.5
E02000516,6709,100,4044,60.3,3711,55.3,333,5,160,2.4,120,1.8,40,0.6,2505,37.3
E02000517,7945,100,4690,59,4352,54.8,338,4.3,209,2.6,147,1.9,62,0.8,3046,38.3
E02000518,7373,100,4417,59.9,4112,55.8,305,4.1,174,2.4,113,1.5,61,0.8,2782,37.7
E02000519,7318,100,4036,55.2,3712,50.7,324,4.4,236,3.2,184,2.5,52,0.7,3046,41.6
E02000520,10789,100,6487,60.1,5911,54.8,576,5.3,333,3.1,232,2.2,101,0.9,3969,36.8
E02000521,10054,100,6420,63.9,5900,58.7,520,5.2,289,2.9,205,2,84,0.8,3345,33.3
E02000522,7394,100,4663,63.1,4316,58.4,347,4.7,175,2.4,118,1.6,57,0.8,2556,34.6
E02000523,9031,100,5677,62.9,5193,57.5,484,5.4,278,3.1,202,2.2,76,0.8,3076,34.1
E02000524,6063,100,3980,65.6,3641,60.1,339,5.6,181,3,128,2.1,53,0.9,1902,31.4
E02000525,7704,100,4909,63.7,4422,57.4,487,6.3,199,2.6,145,1.9,54,0.7,2596,33.7
E02006796,7721,100,5160,66.8,4892,63.4,268,3.5,110,1.4,79,1,31,0.4,2451,31.7
E02000526,7173,100,4766,66.4,4574,63.8,192,2.7,134,1.9,117,1.6,17,0.2,2273,31.7
E02000529,7552,100,4417,58.5,4045,53.6,372,4.9,220,2.9,156,2.1,64,0.8,2915,38.6
E02000530,6038,100,3440,57,3118,51.6,322,5.3,195,3.2,128,2.1,67,1.1,2403,39.8
E02000531,9426,100,6278,66.6,5927,62.9,351,3.7,210,2.2,167,1.8,43,0.5,2938,31.2
E02000532,7285,100,4616,63.4,4361,59.9,255,3.5,101,1.4,76,1,25,0.3,2568,35.3
E02000533,6761,100,4490,66.4,4269,63.1,221,3.3,91,1.3,74,1.1,17,0.3,2180,32.2
E02000534,6939,100,4563,65.8,4285,61.8,278,4,177,2.6,129,1.9,48,0.7,2199,31.7
E02000535,8113,100,4731,58.3,4337,53.5,394,4.9,217,2.7,164,2,53,0.7,3165,39
E02000536,8698,100,5117,58.8,4747,54.6,370,4.3,231,2.7,166,1.9,65,0.7,3350,38.5
E02000537,8138,100,5012,61.6,4698,57.7,314,3.9,458,5.6,309,3.8,149,1.8,2668,32.8
E02000538,8163,100,5018,61.5,4573,56,445,5.5,214,2.6,142,1.7,72,0.9,2931,35.9
E02000539,9612,100,6545,68.1,6138,63.9,407,4.2,180,1.9,124,1.3,56,0.6,2887,30
E02000540,9510,100,6223,65.4,5778,60.8,445,4.7,267,2.8,198,2.1,69,0.7,3020,31.8
E02000541,8451,100,5085,60.2,4603,54.5,482,5.7,239,2.8,183,2.2,56,0.7,3127,37
E02000542,9578,100,5891,61.5,5357,55.9,534,5.6,286,3,200,2.1,86,0.9,3401,35.5
E02000543,10896,100,7201,66.1,6625,60.8,576,5.3,351,3.2,261,2.4,90,0.8,3344,30.7
E02000544,7015,100,4422,63,4182,59.6,240,3.4,179,2.6,124,1.8,55,0.8,2414,34.4
E02000545,7147,100,4461,62.4,4177,58.4,284,4,151,2.1,95,1.3,56,0.8,2535,35.5
E02000546,8183,100,4967,60.7,4602,56.2,365,4.5,283,3.5,214,2.6,69,0.8,2933,35.8
E02000547,8638,100,5292,61.3,4926,57,366,4.2,213,2.5,150,1.7,63,0.7,3133,36.3
E02000548,8122,100,5130,63.2,4764,58.7,366,4.5,197,2.4,159,2,38,0.5,2795,34.4
E02000549,10113,100,6348,62.8,5907,58.4,441,4.4,300,3,232,2.3,68,0.7,3465,34.3
E02000550,8228,100,5466,66.4,5054,61.4,412,5,218,2.6,150,1.8,68,0.8,2544,30.9
E02000551,7426,100,4567,61.5,4200,56.6,367,4.9,181,2.4,122,1.6,59,0.8,2678,36.1
E02000552,7189,100,4800,66.8,4484,62.4,316,4.4,152,2.1,113,1.6,39,0.5,2237,31.1
E02000553,5513,100,3449,62.6,3216,58.3,233,4.2,110,2,77,1.4,33,0.6,1954,35.4
E02006792,7660,100,5067,66.1,4788,62.5,279,3.6,141,1.8,107,1.4,34,0.4,2452,32
E02006972,4288,100,2788,65,2573,60,215,5,84,2,62,1.4,22,0.5,1416,33
E02006973,6813,100,4499,66,4148,60.9,351,5.2,162,2.4,124,1.8,38,0.6,2152,31.6
E02000554,7635,100,4788,62.7,4415,57.8,373,4.9,170,2.2,118,1.5,52,0.7,2677,35.1
E02000555,7967,100,5125,64.3,4743,59.5,382,4.8,232,2.9,174,2.2,58,0.7,2610,32.8
E02000556,9788,100,6706,68.5,6272,64.1,434,4.4,275,2.8,205,2.1,70,0.7,2807,28.7
E02000557,7461,100,4941,66.2,4613,61.8,328,4.4,194,2.6,154,2.1,40,0.5,2326,31.2
E02000558,7617,100,4371,57.4,3872,50.8,499,6.6,272,3.6,176,2.3,96,1.3,2974,39
E02000559,7934,100,5752,72.5,5467,68.9,285,3.6,176,2.2,134,1.7,42,0.5,2006,25.3
E02000560,6404,100,4435,69.3,4130,64.5,305,4.8,283,4.4,209,3.3,74,1.2,1686,26.3
E02000561,6286,100,4245,67.5,4028,64.1,217,3.5,173,2.8,121,1.9,52,0.8,1868,29.7
E02000562,6640,100,4522,68.1,4232,63.7,290,4.4,108,1.6,93,1.4,15,0.2,2010,30.3
E02000563,7241,100,4409,60.9,4021,55.5,388,5.4,256,3.5,191,2.6,65,0.9,2576,35.6
E02000564,10811,100,7581,70.1,7128,65.9,453,4.2,335,3.1,238,2.2,97,0.9,2895,26.8
E02000565,7116,100,4716,66.3,4285,60.2,431,6.1,203,2.9,140,2,63,0.9,2197,30.9
E02000566,7239,100,5119,70.7,4880,67.4,239,3.3,148,2,112,1.5,36,0.5,1972,27.2
E02000567,8948,100,6209,69.4,5836,65.2,373,4.2,143,1.6,108,1.2,35,0.4,2596,29
E02000568,9586,100,5474,57.1,4955,51.7,519,5.4,367,3.8,271,2.8,96,1,3745,39.1
E02000569,8234,100,5290,64.2,4937,60,353,4.3,164,2,110,1.3,54,0.7,2780,33.8
E02000570,7151,100,5101,71.3,4820,67.4,281,3.9,150,2.1,115,1.6,35,0.5,1900,26.6
E02000571,7504,100,4888,65.1,4573,60.9,315,4.2,145,1.9,96,1.3,49,0.7,2471,32.9
E02000572,7146,100,4047,56.6,3640,50.9,407,5.7,361,5.1,252,3.5,109,1.5,2738,38.3
E02000573,9026,100,6188,68.6,5904,65.4,284,3.1,257,2.8,163,1.8,94,1,2581,28.6
E02000574,7026,100,4164,59.3,3887,55.3,277,3.9,313,4.5,185,2.6,128,1.8,2549,36.3
E02000575,9879,100,5905,59.8,5508,55.8,397,4,442,4.5,253,2.6,189,1.9,3532,35.8
E02000576,8977,100,5453,60.7,5007,55.8,446,5,309,3.4,193,2.1,116,1.3,3215,35.8
E02000577,6575,100,3608,54.9,3208,48.8,400,6.1,189,2.9,142,2.2,47,0.7,2778,42.3
E02000578,4913,100,2491,50.7,2233,45.5,258,5.3,123,2.5,71,1.4,52,1.1,2299,46.8
E02000579,7487,100,4617,61.7,4280,57.2,337,4.5,116,1.5,75,1,41,0.5,2754,36.8
E02000580,6944,100,4356,62.7,3950,56.9,406,5.8,104,1.5,87,1.3,17,0.2,2484,35.8
E02000581,6148,100,3271,53.2,2847,46.3,424,6.9,126,2,87,1.4,39,0.6,2751,44.7
E02000582,5724,100,3600,62.9,3409,59.6,191,3.3,144,2.5,106,1.9,38,0.7,1980,34.6
E02000583,5528,100,3555,64.3,3374,61,181,3.3,84,1.5,73,1.3,11,0.2,1889,34.2
E02000584,6000,100,3798,63.3,3566,59.4,232,3.9,103,1.7,50,0.8,53,0.9,2099,35
E02000585,6711,100,4094,61,3795,56.5,299,4.5,83,1.2,54,0.8,29,0.4,2534,37.8
E02000586,5573,100,3108,55.8,2987,53.6,121,2.2,91,1.6,69,1.2,22,0.4,2374,42.6
E02000587,5559,100,3358,60.4,3197,57.5,161,2.9,81,1.5,59,1.1,22,0.4,2120,38.1
E02000588,5197,100,3019,58.1,2906,55.9,113,2.2,80,1.5,61,1.2,19,0.4,2098,40.4
E02000589,6440,100,3761,58.4,3532,54.8,229,3.6,168,2.6,111,1.7,57,0.9,2511,39
E02000590,5230,100,2948,56.4,2719,52,229,4.4,125,2.4,56,1.1,69,1.3,2157,41.2
E02000591,5447,100,3136,57.6,2916,53.5,220,4,149,2.7,106,1.9,43,0.8,2162,39.7
E02000592,4942,100,3109,62.9,2974,60.2,135,2.7,117,2.4,84,1.7,33,0.7,1716,34.7
E02000593,6460,100,3838,59.4,3630,56.2,208,3.2,142,2.2,93,1.4,49,0.8,2480,38.4
E02000594,5764,100,3369,58.4,3222,55.9,147,2.6,59,1,38,0.7,21,0.4,2336,40.5
E02000595,5293,100,3064,57.9,2906,54.9,158,3,81,1.5,58,1.1,23,0.4,2148,40.6
E02000596,5801,100,3674,63.3,3478,60,196,3.4,116,2,90,1.6,26,0.4,2011,34.7
E02000597,5357,100,2930,54.7,2669,49.8,261,4.9,89,1.7,67,1.3,22,0.4,2338,43.6
E02000598,6193,100,3937,63.6,3762,60.7,175,2.8,86,1.4,71,1.1,15,0.2,2170,35
E02000599,5787,100,3052,52.7,2914,50.4,138,2.4,152,2.6,106,1.8,46,0.8,2583,44.6
E02000600,6545,100,4236,64.7,4067,62.1,169,2.6,197,3,141,2.2,56,0.9,2112,32.3
E02000601,9213,100,6203,67.3,5884,63.9,319,3.5,227,2.5,146,1.6,81,0.9,2783,30.2
E02000602,8261,100,4685,56.7,4380,53,305,3.7,506,6.1,348,4.2,158,1.9,3070,37.2
E02000603,6854,100,4092,59.7,3811,55.6,281,4.1,288,4.2,184,2.7,104,1.5,2474,36.1
E02000604,7286,100,4759,65.3,4529,62.2,230,3.2,142,1.9,118,1.6,24,0.3,2385,32.7
E02000605,6743,100,4167,61.8,3975,59,192,2.8,100,1.5,80,1.2,20,0.3,2476,36.7
E02000606,9126,100,5694,62.4,5463,59.9,231,2.5,551,6,383,4.2,168,1.8,2881,31.6
E02000607,5572,100,3340,59.9,3190,57.3,150,2.7,282,5.1,173,3.1,109,2,1950,35
E02000608,6242,100,4358,69.8,4157,66.6,201,3.2,252,4,156,2.5,96,1.5,1632,26.1
E02000609,6216,100,3553,57.2,3355,54,198,3.2,107,1.7,96,1.5,11,0.2,2556,41.1
E02000610,6721,100,4540,67.5,4316,64.2,224,3.3,183,2.7,142,2.1,41,0.6,1998,29.7
E02000611,5950,100,3580,60.2,3438,57.8,142,2.4,101,1.7,73,1.2,28,0.5,2269,38.1
E02000612,6762,100,4127,61,3951,58.4,176,2.6,98,1.4,75,1.1,23,0.3,2537,37.5
E02000613,6339,100,4243,66.9,4037,63.7,206,3.2,116,1.8,91,1.4,25,0.4,1980,31.2
E02000614,7393,100,4791,64.8,4542,61.4,249,3.4,209,2.8,158,2.1,51,0.7,2393,32.4
E02000615,6293,100,4123,65.5,3940,62.6,183,2.9,149,2.4,108,1.7,41,0.7,2021,32.1
E02000616,4876,100,3334,68.4,3224,66.1,110,2.3,100,2.1,74,1.5,26,0.5,1442,29.6
E02000617,7093,100,4612,65,4406,62.1,206,2.9,113,1.6,85,1.2,28,0.4,2368,33.4
E02000619,7556,100,4942,65.4,4491,59.4,451,6,194,2.6,138,1.8,56,0.7,2420,32
E02000620,8517,100,5796,68.1,5416,63.6,380,4.5,244,2.9,173,2,71,0.8,2477,29.1
E02000621,11288,100,7743,68.6,7274,64.4,469,4.2,383,3.4,235,2.1,148,1.3,3162,28
E02000622,7358,100,5294,71.9,4956,67.4,338,4.6,212,2.9,145,2,67,0.9,1852,25.2
E02000623,6652,100,4479,67.3,4108,61.8,371,5.6,191,2.9,145,2.2,46,0.7,1982,29.8
E02000624,8263,100,6027,72.9,5527,66.9,500,6.1,228,2.8,162,2,66,0.8,2008,24.3
E02000625,7696,100,5432,70.6,5000,65,432,5.6,268,3.5,205,2.7,63,0.8,1996,25.9
E02000626,6792,100,4445,65.4,4002,58.9,443,6.5,238,3.5,168,2.5,70,1,2109,31.1
E02000627,8251,100,5935,71.9,5585,67.7,350,4.2,260,3.2,187,2.3,73,0.9,2056,24.9
E02000628,9236,100,6164,66.7,5630,61,534,5.8,416,4.5,262,2.8,154,1.7,2656,28.8
E02000629,8093,100,6195,76.5,5918,73.1,277,3.4,176,2.2,146,1.8,30,0.4,1722,21.3
E02000630,6609,100,4961,75.1,4744,71.8,217,3.3,113,1.7,86,1.3,27,0.4,1535,23.2
E02000631,7953,100,5751,72.3,5405,68,346,4.4,219,2.8,158,2,61,0.8,1983,24.9
E02000632,8902,100,7274,81.7,6974,78.3,300,3.4,187,2.1,153,1.7,34,0.4,1441,16.2
E02000633,7848,100,5468,69.7,5089,64.8,379,4.8,225,2.9,168,2.1,57,0.7,2155,27.5
E02000634,5892,100,4176,70.9,3933,66.8,243,4.1,139,2.4,102,1.7,37,0.6,1577,26.8
E02000635,8476,100,6268,73.9,5899,69.6,369,4.4,222,2.6,170,2,52,0.6,1986,23.4
E02000636,6508,100,5132,78.9,4953,76.1,179,2.8,93,1.4,69,1.1,24,0.4,1283,19.7
E02000637,7408,100,5781,78,5493,74.1,288,3.9,179,2.4,138,1.9,41,0.6,1448,19.5
E02000638,8756,100,6004,68.6,5596,63.9,408,4.7,224,2.6,152,1.7,72,0.8,2528,28.9
E02000639,7157,100,4972,69.5,4542,63.5,430,6,210,2.9,171,2.4,39,0.5,1975,27.6
E02000640,7712,100,5881,76.3,5622,72.9,259,3.4,130,1.7,97,1.3,33,0.4,1701,22.1
E02000641,6825,100,4389,64.3,4002,58.6,387,5.7,230,3.4,144,2.1,86,1.3,2206,32.3
E02000642,8014,100,5550,69.3,5250,65.5,300,3.7,146,1.8,96,1.2,50,0.6,2318,28.9
E02000643,7881,100,5774,73.3,5439,69,335,4.3,168,2.1,119,1.5,49,0.6,1939,24.6
E02000644,6916,100,5077,73.4,4785,69.2,292,4.2,118,1.7,89,1.3,29,0.4,1721,24.9
E02000645,7702,100,5395,70,5059,65.7,336,4.4,153,2,114,1.5,39,0.5,2154,28
E02000646,7964,100,5791,72.7,5486,68.9,305,3.8,136,1.7,114,1.4,22,0.3,2037,25.6
E02000647,6933,100,4683,67.5,4382,63.2,301,4.3,139,2,104,1.5,35,0.5,2111,30.4
E02000648,6074,100,3899,64.2,3556,58.5,343,5.6,185,3,107,1.8,78,1.3,1990,32.8
E02000649,10421,100,7755,74.4,7264,69.7,491,4.7,224,2.1,172,1.7,52,0.5,2442,23.4
E02000650,6164,100,4244,68.9,3922,63.6,322,5.2,124,2,80,1.3,44,0.7,1796,29.1
E02000651,7209,100,5016,69.6,4697,65.2,319,4.4,137,1.9,107,1.5,30,0.4,2056,28.5
E02000652,6166,100,4042,65.6,3763,61,279,4.5,178,2.9,120,1.9,58,0.9,1946,31.6
E02006801,7751,100,4300,55.5,4011,51.7,289,3.7,420,5.4,250,3.2,170,2.2,3031,39.1
E02000653,10607,100,7372,69.5,6847,64.6,525,4.9,400,3.8,309,2.9,91,0.9,2835,26.7
E02000654,7017,100,4508,64.2,4053,57.8,455,6.5,329,4.7,233,3.3,96,1.4,2180,31.1
E02000655,8398,100,5539,66,5021,59.8,518,6.2,495,5.9,338,4,157,1.9,2364,28.1
E02000657,8350,100,5253,62.9,4855,58.1,398,4.8,445,5.3,287,3.4,158,1.9,2652,31.8
E02000658,7293,100,5016,68.8,4625,63.4,391,5.4,276,3.8,190,2.6,86,1.2,2001,27.4
E02000659,6672,100,4560,68.3,4267,64,293,4.4,170,2.5,123,1.8,47,0.7,1942,29.1
E02000660,6897,100,5103,74,4800,69.6,303,4.4,230,3.3,157,2.3,73,1.1,1564,22.7
E02000661,5415,100,3752,69.3,3478,64.2,274,5.1,135,2.5,95,1.8,40,0.7,1528,28.2
E02000662,6598,100,4585,69.5,4266,64.7,319,4.8,203,3.1,144,2.2,59,0.9,1810,27.4
E02000663,5654,100,3903,69,3641,64.4,262,4.6,188,3.3,135,2.4,53,0.9,1563,27.6
E02000665,6570,100,4493,68.4,4207,64,286,4.4,141,2.1,112,1.7,29,0.4,1936,29.5
E02000666,5764,100,3947,68.5,3710,64.4,237,4.1,146,2.5,111,1.9,35,0.6,1671,29
E02000667,5334,100,3775,70.8,3588,67.3,187,3.5,108,2,82,1.5,26,0.5,1451,27.2
E02000668,5293,100,3531,66.7,3301,62.4,230,4.3,141,2.7,106,2,35,0.7,1621,30.6
E02000669,6442,100,4512,70,4175,64.8,337,5.2,152,2.4,121,1.9,31,0.5,1778,27.6
E02000670,5389,100,3557,66,3311,61.4,246,4.6,125,2.3,99,1.8,26,0.5,1707,31.7
E02000671,6991,100,5081,72.7,4779,68.4,302,4.3,146,2.1,114,1.6,32,0.5,1764,25.2
E02000672,8217,100,5626,68.5,5202,63.3,424,5.2,184,2.2,140,1.7,44,0.5,2407,29.3
E02000673,6630,100,4887,73.7,4593,69.3,294,4.4,135,2,99,1.5,36,0.5,1608,24.3
E02000674,6793,100,4442,65.4,4111,60.5,331,4.9,136,2,107,1.6,29,0.4,2215,32.6
E02000675,6832,100,4468,65.4,4186,61.3,282,4.1,143,2.1,101,1.5,42,0.6,2221,32.5
E02000676,6250,100,4509,72.1,4268,68.3,241,3.9,133,2.1,93,1.5,40,0.6,1608,25.7
E02000677,5868,100,3744,63.8,3477,59.3,267,4.6,139,2.4,114,1.9,25,0.4,1985,33.8
E02000678,5332,100,3300,61.9,3035,56.9,265,5,137,2.6,101,1.9,36,0.7,1895,35.5
E02000679,6406,100,4328,67.6,4000,62.4,328,5.1,145,2.3,119,1.9,26,0.4,1933,30.2
E02000680,5508,100,3704,67.2,3431,62.3,273,5,132,2.4,104,1.9,28,0.5,1672,30.4
E02000681,6673,100,4105,61.5,3808,57.1,297,4.5,181,2.7,125,1.9,56,0.8,2387,35.8
E02000682,6834,100,4085,59.8,3711,54.3,374,5.5,189,2.8,128,1.9,61,0.9,2560,37.5
E02000683,5416,100,3412,63,3112,57.5,300,5.5,130,2.4,108,2,22,0.4,1874,34.6
E02000685,6456,100,4216,65.3,3932,60.9,284,4.4,169,2.6,121,1.9,48,0.7,2071,32.1
E02000686,5742,100,3541,61.7,3212,55.9,329,5.7,173,3,132,2.3,41,0.7,2028,35.3
E02000687,6620,100,4433,67,4124,62.3,309,4.7,133,2,104,1.6,29,0.4,2054,31
E02006783,5900,100,3688,62.5,3365,57,323,5.5,147,2.5,94,1.6,53,0.9,2065,35
E02006784,6348,100,3832,60.4,3521,55.5,311,4.9,141,2.2,116,1.8,25,0.4,2375,37.4
E02006798,7415,100,4923,66.4,4517,60.9,406,5.5,318,4.3,215,2.9,103,1.4,2174,29.3
E02007008,4928,100,3693,74.9,3446,69.9,247,5,216,4.4,123,2.5,93,1.9,1019,20.7
E02007009,7570,100,5002,66.1,4566,60.3,436,5.8,254,3.4,192,2.5,62,0.8,2314,30.6
E02000689,7031,100,5028,71.5,4838,68.8,190,2.7,113,1.6,83,1.2,30,0.4,1890,26.9
E02000690,4580,100,2400,52.4,2300,50.2,100,2.2,37,0.8,24,0.5,13,0.3,2143,46.8
E02000691,6015,100,4336,72.1,4151,69,185,3.1,98,1.6,76,1.3,22,0.4,1581,26.3
E02000692,6463,100,4296,66.5,4150,64.2,146,2.3,82,1.3,52,0.8,30,0.5,2085,32.3
E02000693,8445,100,6373,75.5,6061,71.8,312,3.7,190,2.2,161,1.9,29,0.3,1882,22.3
E02000694,7344,100,5558,75.7,5328,72.5,230,3.1,99,1.3,75,1,24,0.3,1687,23
E02000695,7129,100,4681,65.7,4422,62,259,3.6,172,2.4,143,2,29,0.4,2276,31.9
E02000696,7073,100,5056,71.5,4726,66.8,330,4.7,210,3,172,2.4,38,0.5,1807,25.5
E02000697,7164,100,5560,77.6,5347,74.6,213,3,100,1.4,74,1,26,0.4,1504,21
E02000698,6465,100,4031,62.4,3894,60.2,137,2.1,93,1.4,63,1,30,0.5,2341,36.2
E02000699,6442,100,4636,72,4440,68.9,196,3,81,1.3,56,0.9,25,0.4,1725,26.8
E02000700,6865,100,4517,65.8,4189,61,328,4.8,162,2.4,132,1.9,30,0.4,2186,31.8
E02000701,7216,100,4667,64.7,4355,60.4,312,4.3,225,3.1,176,2.4,49,0.7,2324,32.2
E02000702,7126,100,4529,63.6,4195,58.9,334,4.7,213,3,158,2.2,55,0.8,2384,33.5
E02000703,6379,100,4028,63.1,3872,60.7,156,2.4,115,1.8,86,1.3,29,0.5,2236,35.1
E02000704,7026,100,4894,69.7,4656,66.3,238,3.4,140,2,105,1.5,35,0.5,1992,28.4
E02000705,7520,100,4889,65,4601,61.2,288,3.8,172,2.3,126,1.7,46,0.6,2459,32.7
E02000706,7652,100,4825,63.1,4510,58.9,315,4.1,215,2.8,168,2.2,47,0.6,2612,34.1
E02000707,6493,100,4006,61.7,3693,56.9,313,4.8,201,3.1,151,2.3,50,0.8,2286,35.2
E02000708,7079,100,4704,66.5,4503,63.6,201,2.8,150,2.1,119,1.7,31,0.4,2225,31.4
E02000709,6405,100,3999,62.4,3824,59.7,175,2.7,126,2,94,1.5,32,0.5,2280,35.6
E02000710,7376,100,4499,61,4190,56.8,309,4.2,183,2.5,151,2,32,0.4,2694,36.5
E02000711,7533,100,4966,65.9,4664,61.9,302,4,201,2.7,167,2.2,34,0.5,2366,31.4
E02000712,7651,100,4704,61.5,4442,58.1,262,3.4,193,2.5,149,1.9,44,0.6,2754,36
E02000713,6306,100,4034,64,3865,61.3,169,2.7,125,2,99,1.6,26,0.4,2147,34
E02000714,6068,100,3882,64,3566,58.8,316,5.2,200,3.3,145,2.4,55,0.9,1986,32.7
E02000715,5318,100,2782,52.3,2535,47.7,247,4.6,234,4.4,167,3.1,67,1.3,2302,43.3
E02000716,5591,100,3137,56.1,2868,51.3,269,4.8,214,3.8,175,3.1,39,0.7,2240,40.1
E02000717,6208,100,3320,53.5,3040,49,280,4.5,275,4.4,210,3.4,65,1,2613,42.1
E02000718,5412,100,2885,53.3,2632,48.6,253,4.7,263,4.9,146,2.7,117,2.2,2264,41.8
E02000719,6571,100,4217,64.2,3861,58.8,356,5.4,276,4.2,214,3.3,62,0.9,2078,31.6
E02000720,5844,100,3417,58.5,3093,52.9,324,5.5,261,4.5,213,3.6,48,0.8,2166,37.1
E02000721,7284,100,3939,54.1,3553,48.8,386,5.3,322,4.4,234,3.2,88,1.2,3023,41.5
E02000722,6749,100,4383,64.9,3968,58.8,415,6.1,300,4.4,238,3.5,62,0.9,2066,30.6
E02000723,8775,100,4788,54.6,4398,50.1,390,4.4,466,5.3,351,4,115,1.3,3521,40.1
E02000724,7501,100,3918,52.2,3580,47.7,338,4.5,361,4.8,278,3.7,83,1.1,3222,43
E02000725,8299,100,5489,66.1,5043,60.8,446,5.4,329,4,256,3.1,73,0.9,2481,29.9
E02000727,6488,100,3442,53.1,3136,48.3,306,4.7,289,4.5,203,3.1,86,1.3,2757,42.5
E02000728,6658,100,3817,57.3,3519,52.9,298,4.5,345,5.2,262,3.9,83,1.2,2496,37.5
E02000729,5758,100,3414,59.3,3127,54.3,287,5,223,3.9,178,3.1,45,0.8,2121,36.8
E02000730,7723,100,4327,56,3862,50,465,6,426,5.5,234,3,192,2.5,2970,38.5
E02000731,7640,100,4096,53.6,3753,49.1,343,4.5,355,4.6,235,3.1,120,1.6,3189,41.7
E02000732,6817,100,3662,53.7,3282,48.1,380,5.6,330,4.8,257,3.8,73,1.1,2825,41.4
E02000733,8196,100,5035,61.4,4585,55.9,450,5.5,337,4.1,243,3,94,1.1,2824,34.5
E02000734,5891,100,3641,61.8,3316,56.3,325,5.5,207,3.5,152,2.6,55,0.9,2043,34.7
E02000735,6665,100,3793,56.9,3486,52.3,307,4.6,327,4.9,234,3.5,93,1.4,2545,38.2
E02000736,6795,100,3776,55.6,3423,50.4,353,5.2,295,4.3,222,3.3,73,1.1,2724,40.1
E02000737,7833,100,4542,58,4101,52.4,441,5.6,338,4.3,236,3,102,1.3,2953,37.7
E02000738,7228,100,4497,62.2,4182,57.9,315,4.4,285,3.9,211,2.9,74,1,2446,33.8
E02000739,6097,100,3650,59.9,3372,55.3,278,4.6,275,4.5,200,3.3,75,1.2,2172,35.6
E02000740,5484,100,3439,62.7,3073,56,366,6.7,233,4.2,168,3.1,65,1.2,1812,33
E02000741,6294,100,3804,60.4,3483,55.3,321,5.1,226,3.6,166,2.6,60,1,2264,36
E02000742,6454,100,3793,58.8,3499,54.2,294,4.6,279,4.3,196,3,83,1.3,2382,36.9
E02000743,8227,100,5081,61.8,4561,55.4,520,6.3,350,4.3,248,3,102,1.2,2796,34
E02000744,7076,100,4409,62.3,4058,57.3,351,5,323,4.6,229,3.2,94,1.3,2344,33.1
E02000745,6806,100,4265,62.7,3926,57.7,339,5,300,4.4,242,3.6,58,0.9,2241,32.9
E02000746,7631,100,4754,62.3,4380,57.4,374,4.9,370,4.8,228,3,142,1.9,2507,32.9
E02000747,10979,100,7596,69.2,7082,64.5,514,4.7,432,3.9,318,2.9,114,1,2951,26.9
E02000748,4964,100,3103,62.5,2875,57.9,228,4.6,289,5.8,213,4.3,76,1.5,1572,31.7
E02000749,7535,100,4504,59.8,4066,54,438,5.8,332,4.4,268,3.6,64,0.8,2699,35.8
E02006995,7287,100,5464,75,5217,71.6,247,3.4,337,4.6,221,3,116,1.6,1486,20.4
E02006996,7190,100,4749,66.1,4454,61.9,295,4.1,410,5.7,259,3.6,151,2.1,2031,28.2
E02006997,6006,100,4562,76,4257,70.9,305,5.1,245,4.1,177,2.9,68,1.1,1199,20
E02006998,5479,100,3668,66.9,3317,60.5,351,6.4,248,4.5,168,3.1,80,1.5,1563,28.5
E02006999,9345,100,7465,79.9,7082,75.8,383,4.1,324,3.5,232,2.5,92,1,1556,16.7
E02000751,9138,100,5382,58.9,5093,55.7,289,3.2,109,1.2,86,0.9,23,0.3,3647,39.9
E02000752,6784,100,4360,64.3,4114,60.6,246,3.6,159,2.3,127,1.9,32,0.5,2265,33.4
E02000753,5381,100,3385,62.9,3157,58.7,228,4.2,117,2.2,90,1.7,27,0.5,1879,34.9
E02000754,5456,100,3606,66.1,3413,62.6,193,3.5,109,2,81,1.5,28,0.5,1741,31.9
E02000755,4411,100,2888,65.5,2745,62.2,143,3.2,93,2.1,74,1.7,19,0.4,1430,32.4
E02000756,11507,100,7196,62.5,6805,59.1,391,3.4,335,2.9,276,2.4,59,0.5,3976,34.6
E02000757,10017,100,6841,68.3,6479,64.7,362,3.6,195,1.9,160,1.6,35,0.3,2981,29.8
E02000758,5452,100,3148,57.7,2956,54.2,192,3.5,151,2.8,112,2.1,39,0.7,2153,39.5
E02000759,10252,100,6683,65.2,6351,61.9,332,3.2,248,2.4,204,2,44,0.4,3321,32.4
E02000760,5917,100,3436,58.1,3245,54.8,191,3.2,150,2.5,123,2.1,27,0.5,2331,39.4
E02000762,5405,100,3149,58.3,2983,55.2,166,3.1,155,2.9,125,2.3,30,0.6,2101,38.9
E02000763,6337,100,3954,62.4,3685,58.2,269,4.2,188,3,156,2.5,32,0.5,2195,34.6
E02000764,10251,100,6622,64.6,6295,61.4,327,3.2,155,1.5,118,1.2,37,0.4,3474,33.9
E02000765,5839,100,3511,60.1,3305,56.6,206,3.5,175,3,148,2.5,27,0.5,2153,36.9
E02000767,6672,100,4083,61.2,3837,57.5,246,3.7,187,2.8,150,2.2,37,0.6,2402,36
E02000768,4612,100,2968,64.4,2826,61.3,142,3.1,54,1.2,35,0.8,19,0.4,1590,34.5
E02000770,6412,100,3745,58.4,3483,54.3,262,4.1,220,3.4,179,2.8,41,0.6,2447,38.2
E02000772,6402,100,3657,57.1,3369,52.6,288,4.5,219,3.4,169,2.6,50,0.8,2526,39.5
E02000773,8199,100,4663,56.9,4368,53.3,295,3.6,272,3.3,184,2.2,88,1.1,3264,39.8
E02000774,6157,100,3523,57.2,3245,52.7,278,4.5,236,3.8,179,2.9,57,0.9,2398,38.9
E02000776,5367,100,3139,58.5,2944,54.9,195,3.6,186,3.5,145,2.7,41,0.8,2042,38
E02000777,4774,100,2942,61.6,2782,58.3,160,3.4,81,1.7,63,1.3,18,0.4,1751,36.7
E02000779,6419,100,3651,56.9,3353,52.2,298,4.6,216,3.4,166,2.6,50,0.8,2552,39.8
E02000781,12330,100,7113,57.7,6615,53.6,498,4,411,3.3,307,2.5,104,0.8,4806,39
E02000782,8469,100,4745,56,4369,51.6,376,4.4,306,3.6,216,2.6,90,1.1,3418,40.4
E02000783,5447,100,2971,54.5,2683,49.3,288,5.3,274,5,154,2.8,120,2.2,2202,40.4
E02006800,11272,100,6650,59,6134,54.4,516,4.6,369,3.3,285,2.5,84,0.7,4253,37.7
E02006924,10928,100,6341,58,5935,54.3,406,3.7,365,3.3,289,2.6,76,0.7,4222,38.6
E02006925,11729,100,6835,58.3,6429,54.8,406,3.5,352,3,264,2.3,88,0.8,4542,38.7
E02007017,6625,100,3945,59.5,3689,55.7,256,3.9,199,3,152,2.3,47,0.7,2481,37.4
E02007018,5373,100,3315,61.7,3094,57.6,221,4.1,172,3.2,136,2.5,36,0.7,1886,35.1
E02007019,5290,100,3082,58.3,2823,53.4,259,4.9,219,4.1,161,3,58,1.1,1989,37.6
E02007020,7394,100,4028,54.5,3737,50.5,291,3.9,231,3.1,176,2.4,55,0.7,3135,42.4
E02000784,8209,100,4881,59.5,4626,56.4,255,3.1,116,1.4,89,1.1,27,0.3,3212,39.1
E02000785,7991,100,5186,64.9,4979,62.3,207,2.6,86,1.1,65,0.8,21,0.3,2719,34
E02000786,8926,100,6158,69,5898,66.1,260,2.9,104,1.2,82,0.9,22,0.2,2664,29.8
E02000787,9591,100,6498,67.8,6166,64.3,332,3.5,124,1.3,93,1,31,0.3,2969,31
E02000788,6964,100,4718,67.7,4522,64.9,196,2.8,84,1.2,65,0.9,19,0.3,2162,31
E02000789,5152,100,3319,64.4,3163,61.4,156,3,47,0.9,34,0.7,13,0.3,1786,34.7
E02000790,5161,100,3689,71.5,3553,68.8,136,2.6,63,1.2,42,0.8,21,0.4,1409,27.3
E02000791,5296,100,3513,66.3,3365,63.5,148,2.8,80,1.5,62,1.2,18,0.3,1703,32.2
E02000792,5782,100,3803,65.8,3642,63,161,2.8,57,1,39,0.7,18,0.3,1922,33.2
E02000793,6560,100,4150,63.3,3929,59.9,221,3.4,87,1.3,67,1,20,0.3,2323,35.4
E02000794,5552,100,3819,68.8,3659,65.9,160,2.9,87,1.6,64,1.2,23,0.4,1646,29.6
E02000795,5294,100,3126,59,3015,57,111,2.1,59,1.1,46,0.9,13,0.2,2109,39.8
E02000796,8766,100,5211,59.4,4881,55.7,330,3.8,204,2.3,165,1.9,39,0.4,3351,38.2
E02000797,6282,100,4480,71.3,4297,68.4,183,2.9,111,1.8,76,1.2,35,0.6,1691,26.9
E02000798,8694,100,5821,67,5558,63.9,263,3,131,1.5,110,1.3,21,0.2,2742,31.5
E02000799,5473,100,2996,54.7,2867,52.4,129,2.4,307,5.6,179,3.3,128,2.3,2170,39.6
E02000800,4128,100,2517,61,2395,58,122,3,53,1.3,42,1,11,0.3,1558,37.7
E02000801,5614,100,3758,66.9,3574,63.7,184,3.3,110,2,87,1.5,23,0.4,1746,31.1
E02000802,5660,100,3687,65.1,3542,62.6,145,2.6,72,1.3,55,1,17,0.3,1901,33.6
E02000803,7823,100,4686,59.9,4393,56.2,293,3.7,110,1.4,88,1.1,22,0.3,3027,38.7
E02000804,5870,100,3725,63.5,3555,60.6,170,2.9,117,2,88,1.5,29,0.5,2028,34.5
E02000805,8717,100,5468,62.7,5211,59.8,257,2.9,152,1.7,119,1.4,33,0.4,3097,35.5
E02000806,8342,100,5154,61.8,4942,59.2,212,2.5,107,1.3,90,1.1,17,0.2,3081,36.9
E02000807,7169,100,5532,77.2,5275,73.6,257,3.6,143,2,117,1.6,26,0.4,1494,20.8
E02000808,9296,100,5590,60.1,5250,56.5,340,3.7,499,5.4,308,3.3,191,2.1,3207,34.5
E02000810,9887,100,6947,70.3,6509,65.8,438,4.4,259,2.6,189,1.9,70,0.7,2681,27.1
E02000812,9117,100,5591,61.3,5220,57.3,371,4.1,457,5,296,3.2,161,1.8,3069,33.7
E02000813,8524,100,5863,68.8,5451,63.9,412,4.8,339,4,231,2.7,108,1.3,2322,27.2
E02000814,8872,100,6761,76.2,6382,71.9,379,4.3,231,2.6,171,1.9,60,0.7,1880,21.2
E02000815,6703,100,4196,62.6,3952,59,244,3.6,407,6.1,277,4.1,130,1.9,2100,31.3
E02000816,7953,100,5269,66.3,4851,61,418,5.3,218,2.7,176,2.2,42,0.5,2466,31
E02000817,5598,100,3388,60.5,3099,55.4,289,5.2,162,2.9,120,2.1,42,0.8,2048,36.6
E02000818,8441,100,5656,67,5257,62.3,399,4.7,338,4,210,2.5,128,1.5,2447,29
E02000819,6958,100,4236,60.9,3838,55.2,398,5.7,301,4.3,226,3.2,75,1.1,2421,34.8
E02000820,7860,100,5073,64.5,4687,59.6,386,4.9,309,3.9,202,2.6,107,1.4,2478,31.5
E02000821,7392,100,4779,64.7,4226,57.2,553,7.5,368,5,244,3.3,124,1.7,2245,30.4
E02000822,5423,100,3433,63.3,3117,57.5,316,5.8,226,4.2,165,3,61,1.1,1764,32.5
E02000823,7321,100,4786,65.4,4382,59.9,404,5.5,322,4.4,259,3.5,63,0.9,2213,30.2
E02000824,7871,100,4950,62.9,4443,56.4,507,6.4,296,3.8,217,2.8,79,1,2625,33.4
E02000825,8230,100,5052,61.4,4536,55.1,516,6.3,359,4.4,270,3.3,89,1.1,2819,34.3
E02000826,8243,100,5429,65.9,4998,60.6,431,5.2,338,4.1,262,3.2,76,0.9,2476,30
E02000827,9373,100,6287,67.1,5753,61.4,534,5.7,327,3.5,230,2.5,97,1,2759,29.4
E02000828,7287,100,4768,65.4,4374,60,394,5.4,309,4.2,212,2.9,97,1.3,2210,30.3
E02000829,9075,100,6048,66.6,5634,62.1,414,4.6,279,3.1,195,2.1,84,0.9,2748,30.3
E02000830,7640,100,5550,72.6,5275,69,275,3.6,228,3,177,2.3,51,0.7,1862,24.4
E02000831,7785,100,5718,73.4,5422,69.6,296,3.8,178,2.3,129,1.7,49,0.6,1889,24.3
E02000832,8019,100,5202,64.9,4768,59.5,434,5.4,245,3.1,204,2.5,41,0.5,2572,32.1
E02000833,5947,100,4084,68.7,3832,64.4,252,4.2,183,3.1,152,2.6,31,0.5,1680,28.2
E02000834,7799,100,5732,73.5,5493,70.4,239,3.1,141,1.8,122,1.6,19,0.2,1926,24.7
E02000835,5938,100,4217,71,4007,67.5,210,3.5,131,2.2,101,1.7,30,0.5,1590,26.8
E02000836,6621,100,4904,74.1,4695,70.9,209,3.2,91,1.4,77,1.2,14,0.2,1626,24.6
E02000837,6592,100,4352,66,4203,63.8,149,2.3,106,1.6,91,1.4,15,0.2,2134,32.4
E02000838,7636,100,5376,70.4,5090,66.7,286,3.7,171,2.2,115,1.5,56,0.7,2089,27.4
E02000839,6616,100,4323,65.3,4035,61,288,4.4,127,1.9,93,1.4,34,0.5,2166,32.7
E02006802,8064,100,4785,59.3,4472,55.5,313,3.9,506,6.3,302,3.7,204,2.5,2773,34.4
E02006941,5020,100,4050,80.7,3900,77.7,150,3,125,2.5,77,1.5,48,1,845,16.8
E02006942,5862,100,4376,74.7,4161,71,215,3.7,182,3.1,136,2.3,46,0.8,1304,22.2
E02000840,7062,100,4548,64.4,4250,60.2,298,4.2,103,1.5,74,1,29,0.4,2411,34.1
E02000841,7149,100,4538,63.5,4269,59.7,269,3.8,172,2.4,128,1.8,44,0.6,2439,34.1
E02000842,6672,100,4225,63.3,4047,60.7,178,2.7,124,1.9,96,1.4,28,0.4,2323,34.8
E02000843,7358,100,5373,73,5155,70.1,218,3,135,1.8,91,1.2,44,0.6,1850,25.1
E02000844,6752,100,4409,65.3,4180,61.9,229,3.4,126,1.9,100,1.5,26,0.4,2217,32.8
E02000845,7307,100,5020,68.7,4793,65.6,227,3.1,131,1.8,93,1.3,38,0.5,2156,29.5
E02000846,6058,100,3888,64.2,3739,61.7,149,2.5,119,2,90,1.5,29,0.5,2051,33.9
E02000847,7584,100,4757,62.7,4546,59.9,211,2.8,121,1.6,100,1.3,21,0.3,2706,35.7
E02000848,6387,100,4247,66.5,4103,64.2,144,2.3,142,2.2,108,1.7,34,0.5,1998,31.3
E02000849,6439,100,4207,65.3,4047,62.9,160,2.5,117,1.8,96,1.5,21,0.3,2115,32.8
E02000850,8661,100,5630,65,5374,62,256,3,142,1.6,108,1.2,34,0.4,2889,33.4
E02000851,9040,100,6157,68.1,5796,64.1,361,4,221,2.4,171,1.9,50,0.6,2662,29.4
E02000852,6427,100,4377,68.1,4196,65.3,181,2.8,107,1.7,86,1.3,21,0.3,1943,30.2
E02000853,6317,100,4222,66.8,4042,64,180,2.8,124,2,100,1.6,24,0.4,1971,31.2
E02000854,6022,100,4004,66.5,3857,64,147,2.4,101,1.7,72,1.2,29,0.5,1917,31.8
E02000855,6629,100,4042,61,3888,58.7,154,2.3,120,1.8,98,1.5,22,0.3,2467,37.2
E02000856,7398,100,4776,64.6,4583,61.9,193,2.6,138,1.9,109,1.5,29,0.4,2484,33.6
E02000857,7279,100,4869,66.9,4621,63.5,248,3.4,103,1.4,73,1,30,0.4,2307,31.7
E02000858,6503,100,3808,58.6,3576,55,232,3.6,127,2,93,1.4,34,0.5,2568,39.5
E02000859,6831,100,3931,57.5,3788,55.5,143,2.1,109,1.6,75,1.1,34,0.5,2791,40.9
E02000860,7009,100,4646,66.3,4379,62.5,267,3.8,96,1.4,73,1,23,0.3,2267,32.3
E02000861,6297,100,3717,59,3576,56.8,141,2.2,85,1.3,62,1,23,0.4,2495,39.6
E02000863,5461,100,3338,61.1,3212,58.8,126,2.3,93,1.7,62,1.1,31,0.6,2030,37.2
E02006836,7014,100,4140,59,3986,56.8,154,2.2,94,1.3,75,1.1,19,0.3,2780,39.6
E02000864,9181,100,5981,65.1,5579,60.8,402,4.4,282,3.1,184,2,98,1.1,2918,31.8
E02000865,6434,100,3901,60.6,3562,55.4,339,5.3,183,2.8,138,2.1,45,0.7,2350,36.5
E02000866,8789,100,5904,67.2,5617,63.9,287,3.3,232,2.6,177,2,55,0.6,2653,30.2
E02000867,9645,100,6849,71,6342,65.8,507,5.3,318,3.3,236,2.4,82,0.9,2478,25.7
E02000868,6106,100,3992,65.4,3739,61.2,253,4.1,264,4.3,158,2.6,106,1.7,1850,30.3
E02000869,4885,100,3109,63.6,2880,59,229,4.7,132,2.7,97,2,35,0.7,1644,33.7
E02000870,5159,100,3216,62.3,2953,57.2,263,5.1,206,4,135,2.6,71,1.4,1737,33.7
E02000871,8960,100,5506,61.5,5018,56,488,5.4,402,4.5,275,3.1,127,1.4,3052,34.1
E02000872,6809,100,4448,65.3,4102,60.2,346,5.1,228,3.3,170,2.5,58,0.9,2133,31.3
E02000873,7972,100,3904,49,3576,44.9,328,4.1,621,7.8,336,4.2,285,3.6,3447,43.2
E02000874,5954,100,3371,56.6,3101,52.1,270,4.5,245,4.1,163,2.7,82,1.4,2338,39.3
E02000875,10701,100,6486,60.6,5882,55,604,5.6,428,4,306,2.9,122,1.1,3787,35.4
E02000876,6036,100,3640,60.3,3361,55.7,279,4.6,271,4.5,178,2.9,93,1.5,2125,35.2
E02000877,10928,100,6795,62.2,6208,56.8,587,5.4,471,4.3,293,2.7,178,1.6,3662,33.5
E02000878,9010,100,5307,58.9,4833,53.6,474,5.3,465,5.2,311,3.5,154,1.7,3238,35.9
E02000879,6670,100,3735,56,3427,51.4,308,4.6,303,4.5,216,3.2,87,1.3,2632,39.5
E02000880,5200,100,3017,58,2787,53.6,230,4.4,255,4.9,186,3.6,69,1.3,1928,37.1
E02000881,8329,100,5004,60.1,4564,54.8,440,5.3,337,4,246,3,91,1.1,2988,35.9
E02000882,8884,100,4941,55.6,4525,50.9,416,4.7,348,3.9,222,2.5,126,1.4,3595,40.5
E02000883,7066,100,3778,53.5,3433,48.6,345,4.9,293,4.1,231,3.3,62,0.9,2995,42.4
E02000884,10818,100,6526,60.3,6126,56.6,400,3.7,595,5.5,382,3.5,213,2,3697,34.2
E02000885,5505,100,2955,53.7,2678,48.6,277,5,209,3.8,151,2.7,58,1.1,2341,42.5
E02000886,7940,100,5436,68.5,5112,64.4,324,4.1,250,3.1,192,2.4,58,0.7,2254,28.4
E02000887,8344,100,5065,60.7,4593,55,472,5.7,309,3.7,190,2.3,119,1.4,2970,35.6
E02000888,6931,100,4584,66.1,4263,61.5,321,4.6,245,3.5,152,2.2,93,1.3,2102,30.3
E02000889,7439,100,5284,71,5002,67.2,282,3.8,206,2.8,133,1.8,73,1,1949,26.2
E02000890,5171,100,3956,76.5,3782,73.1,174,3.4,97,1.9,62,1.2,35,0.7,1118,21.6
E02000893,5978,100,3909,65.4,3558,59.5,351,5.9,207,3.5,146,2.4,61,1,1862,31.1
E02000894,9019,100,6302,69.9,5885,65.3,417,4.6,365,4,274,3,91,1,2352,26.1
E02006853,9109,100,6406,70.3,6002,65.9,404,4.4,303,3.3,189,2.1,114,1.3,2400,26.3
E02006854,6213,100,4577,73.7,4355,70.1,222,3.6,184,3,134,2.2,50,0.8,1452,23.4
E02007112,5235,100,4169,79.6,3898,74.5,271,5.2,145,2.8,100,1.9,45,0.9,921,17.6
E02007113,6104,100,4477,73.3,4197,68.8,280,4.6,195,3.2,143,2.3,52,0.9,1432,23.5
E02007114,6344,100,3895,61.4,3593,56.6,302,4.8,505,8,341,5.4,164,2.6,1944,30.6
E02000895,6836,100,3870,56.6,3659,53.5,211,3.1,132,1.9,100,1.5,32,0.5,2834,41.5
E02000896,7648,100,4805,62.8,4550,59.5,255,3.3,125,1.6,100,1.3,25,0.3,2718,35.5
E02000897,6872,100,4196,61.1,3907,56.9,289,4.2,114,1.7,77,1.1,37,0.5,2562,37.3
E02000898,6488,100,3875,59.7,3625,55.9,250,3.9,107,1.6,80,1.2,27,0.4,2506,38.6
E02000899,7106,100,4325,60.9,4060,57.1,265,3.7,152,2.1,120,1.7,32,0.5,2629,37
E02000900,7040,100,4269,60.6,3948,56.1,321,4.6,188,2.7,148,2.1,40,0.6,2583,36.7
E02000901,8390,100,5536,66,5221,62.2,315,3.8,156,1.9,122,1.5,34,0.4,2698,32.2
E02000902,7583,100,4967,65.5,4626,61,341,4.5,176,2.3,130,1.7,46,0.6,2440,32.2
E02000903,7977,100,4963,62.2,4543,57,420,5.3,264,3.3,178,2.2,86,1.1,2750,34.5
E02000904,6655,100,4532,68.1,4250,63.9,282,4.2,182,2.7,131,2,51,0.8,1941,29.2
E02000905,8009,100,5584,69.7,5273,65.8,311,3.9,243,3,162,2,81,1,2182,27.2
E02000906,7600,100,5266,69.3,4918,64.7,348,4.6,177,2.3,124,1.6,53,0.7,2157,28.4
E02000907,8138,100,5125,63,4578,56.3,547,6.7,205,2.5,150,1.8,55,0.7,2808,34.5
E02000908,10470,100,7352,70.2,6937,66.3,415,4,415,4,278,2.7,137,1.3,2703,25.8
E02000909,7260,100,5053,69.6,4776,65.8,277,3.8,155,2.1,123,1.7,32,0.4,2052,28.3
E02000910,9280,100,6459,69.6,6061,65.3,398,4.3,236,2.5,201,2.2,35,0.4,2585,27.9
E02000911,10370,100,7371,71.1,6849,66,522,5,249,2.4,199,1.9,50,0.5,2750,26.5
E02000912,7760,100,4996,64.4,4650,59.9,346,4.5,171,2.2,118,1.5,53,0.7,2593,33.4
E02000913,7543,100,4714,62.5,4434,58.8,280,3.7,179,2.4,135,1.8,44,0.6,2650,35.1
E02000914,9254,100,5560,60.1,4976,53.8,584,6.3,321,3.5,247,2.7,74,0.8,3373,36.4
E02000915,6698,100,4618,68.9,4331,64.7,287,4.3,181,2.7,140,2.1,41,0.6,1899,28.4
E02000916,8483,100,5706,67.3,5331,62.8,375,4.4,264,3.1,166,2,98,1.2,2513,29.6
E02000917,7714,100,5410,70.1,5053,65.5,357,4.6,261,3.4,219,2.8,42,0.5,2043,26.5
E02000918,7558,100,5118,67.7,4747,62.8,371,4.9,249,3.3,202,2.7,47,0.6,2191,29
E02000919,7622,100,5207,68.3,4858,63.7,349,4.6,283,3.7,225,3,58,0.8,2132,28
E02000920,8373,100,5344,63.8,4932,58.9,412,4.9,289,3.5,238,2.8,51,0.6,2740,32.7
E02000921,9127,100,5911,64.8,5421,59.4,490,5.4,375,4.1,317,3.5,58,0.6,2841,31.1
E02000922,8327,100,5516,66.2,5150,61.8,366,4.4,342,4.1,279,3.4,63,0.8,2469,29.7
E02000923,6534,100,4468,68.4,4283,65.5,185,2.8,97,1.5,76,1.2,21,0.3,1969,30.1
E02000925,6480,100,4325,66.7,4047,62.5,278,4.3,178,2.7,120,1.9,58,0.9,1977,30.5
E02000926,10059,100,7686,76.4,7332,72.9,354,3.5,183,1.8,148,1.5,35,0.3,2190,21.8
E02000927,6126,100,4351,71,4118,67.2,233,3.8,94,1.5,68,1.1,26,0.4,1681,27.4
E02000928,6951,100,5010,72.1,4805,69.1,205,2.9,70,1,57,0.8,13,0.2,1871,26.9
E02000929,6561,100,4191,63.9,3848,58.6,343,5.2,191,2.9,138,2.1,53,0.8,2179,33.2
E02000930,8850,100,6876,77.7,6625,74.9,251,2.8,175,2,137,1.5,38,0.4,1799,20.3
E02000931,7109,100,5725,80.5,5572,78.4,153,2.2,115,1.6,62,0.9,53,0.7,1269,17.9
E02000932,11132,100,8859,79.6,8552,76.8,307,2.8,157,1.4,117,1.1,40,0.4,2116,19
E02000933,7535,100,5241,69.6,5021,66.6,220,2.9,116,1.5,88,1.2,28,0.4,2178,28.9
E02000934,7929,100,6261,79,6014,75.8,247,3.1,126,1.6,96,1.2,30,0.4,1542,19.4
E02000935,5740,100,2656,46.3,2416,42.1,240,4.2,569,9.9,315,5.5,254,4.4,2515,43.8
E02000936,8150,100,5979,73.4,5742,70.5,237,2.9,121,1.5,102,1.3,19,0.2,2050,25.2
E02000937,6388,100,4764,74.6,4592,71.9,172,2.7,64,1,47,0.7,17,0.3,1560,24.4
E02000938,8596,100,5451,63.4,5114,59.5,337,3.9,225,2.6,170,2,55,0.6,2920,34
E02000939,5997,100,4210,70.2,4083,68.1,127,2.1,50,0.8,44,0.7,6,0.1,1737,29
E02000940,7888,100,5950,75.4,5674,71.9,276,3.5,127,1.6,103,1.3,24,0.3,1811,23
E02000941,8208,100,6236,76,5999,73.1,237,2.9,102,1.2,82,1,20,0.2,1870,22.8
E02000942,7881,100,5730,72.7,5509,69.9,221,2.8,91,1.2,71,0.9,20,0.3,2060,26.1
E02000943,7497,100,5803,77.4,5633,75.1,170,2.3,111,1.5,94,1.3,17,0.2,1583,21.1
E02000944,6100,100,3858,63.2,3592,58.9,266,4.4,144,2.4,107,1.8,37,0.6,2098,34.4
E02000945,6270,100,3587,57.2,3302,52.7,285,4.5,354,5.6,224,3.6,130,2.1,2329,37.1
E02000946,7149,100,4860,68,4541,63.5,319,4.5,140,2,86,1.2,54,0.8,2149,30.1
E02000947,7519,100,5805,77.2,5583,74.3,222,3,107,1.4,83,1.1,24,0.3,1607,21.4
E02000948,8706,100,6920,79.5,6665,76.6,255,2.9,100,1.1,75,0.9,25,0.3,1686,19.4
E02000949,8486,100,6381,75.2,6177,72.8,204,2.4,94,1.1,73,0.9,21,0.2,2011,23.7
E02000950,6225,100,4232,68,3949,63.4,283,4.5,125,2,96,1.5,29,0.5,1868,30
E02000951,5582,100,4162,74.6,3955,70.9,207,3.7,90,1.6,65,1.2,25,0.4,1330,23.8
E02000952,5242,100,3906,74.5,3736,71.3,170,3.2,70,1.3,59,1.1,11,0.2,1266,24.2
E02000953,6256,100,4645,74.2,4490,71.8,155,2.5,186,3,131,2.1,55,0.9,1425,22.8
E02000954,5136,100,3562,69.4,3402,66.2,160,3.1,101,2,75,1.5,26,0.5,1473,28.7
E02000955,5735,100,3874,67.6,3688,64.3,186,3.2,115,2,88,1.5,27,0.5,1746,30.4
E02000956,6366,100,4278,67.2,4049,63.6,229,3.6,246,3.9,171,2.7,75,1.2,1842,28.9
E02000957,9125,100,6401,70.1,6113,67,288,3.2,261,2.9,214,2.3,47,0.5,2463,27
E02000958,6693,100,4210,62.9,3947,59,263,3.9,217,3.2,133,2,84,1.3,2266,33.9
E02000959,6314,100,4352,68.9,4076,64.6,276,4.4,159,2.5,82,1.3,77,1.2,1803,28.6
E02007083,6741,100,5005,74.2,4739,70.3,266,3.9,195,2.9,150,2.2,45,0.7,1541,22.9
E02007084,8290,100,5682,68.5,5230,63.1,452,5.5,261,3.1,176,2.1,85,1,2347,28.3
E02000960,5222,100,3022,57.9,2873,55,149,2.9,81,1.6,61,1.2,20,0.4,2119,40.6
E02000961,8020,100,4864,60.6,4503,56.1,361,4.5,127,1.6,96,1.2,31,0.4,3029,37.8
E02000962,6725,100,3753,55.8,3535,52.6,218,3.2,204,3,130,1.9,74,1.1,2768,41.2
E02000963,8646,100,4898,56.7,4374,50.6,524,6.1,235,2.7,156,1.8,79,0.9,3513,40.6
E02000964,10293,100,6231,60.5,5698,55.4,533,5.2,219,2.1,167,1.6,52,0.5,3843,37.3
E02000965,6798,100,4911,72.2,4619,67.9,292,4.3,142,2.1,104,1.5,38,0.6,1745,25.7
E02000966,7961,100,5291,66.5,5011,62.9,280,3.5,105,1.3,73,0.9,32,0.4,2565,32.2
E02000967,5427,100,3205,59.1,3077,56.7,128,2.4,241,4.4,124,2.3,117,2.2,1981,36.5
E02000968,12042,100,5586,46.4,4980,41.4,606,5,426,3.5,287,2.4,139,1.2,6030,50.1
E02000969,7838,100,4113,52.5,3688,47.1,425,5.4,235,3,158,2,77,1,3490,44.5
E02000970,6121,100,3934,64.3,3788,61.9,146,2.4,122,2,83,1.4,39,0.6,2065,33.7
E02000971,6748,100,4204,62.3,3974,58.9,230,3.4,222,3.3,154,2.3,68,1,2322,34.4
E02000972,7270,100,4221,58.1,4000,55,221,3,242,3.3,154,2.1,88,1.2,2807,38.6
E02000973,8792,100,5971,67.9,5524,62.8,447,5.1,154,1.8,102,1.2,52,0.6,2667,30.3
E02000974,7689,100,4235,55.1,4023,52.3,212,2.8,265,3.4,157,2,108,1.4,3189,41.5
E02000975,6754,100,4409,65.3,4183,61.9,226,3.3,180,2.7,125,1.9,55,0.8,2165,32.1
E02000976,7514,100,4708,62.7,4381,58.3,327,4.4,216,2.9,174,2.3,42,0.6,2590,34.5
E02000977,5915,100,3456,58.4,3279,55.4,177,3,151,2.6,86,1.5,65,1.1,2308,39
E02000978,6260,100,3168,50.6,3083,49.2,85,1.4,137,2.2,89,1.4,48,0.8,2955,47.2
E02000979,7085,100,4233,59.7,3985,56.2,248,3.5,192,2.7,112,1.6,80,1.1,2660,37.5
E02000980,7653,100,4585,59.9,4225,55.2,360,4.7,208,2.7,164,2.1,44,0.6,2860,37.4
E02000981,7518,100,4956,65.9,4728,62.9,228,3,135,1.8,93,1.2,42,0.6,2427,32.3
E02000982,6576,100,3778,57.5,3443,52.4,335,5.1,174,2.6,117,1.8,57,0.9,2624,39.9
E02000983,6594,100,4003,60.7,3715,56.3,288,4.4,136,2.1,87,1.3,49,0.7,2455,37.2
E02003314,5620,100,3139,55.9,3004,53.5,135,2.4,57,1,36,0.6,21,0.4,2424,43.1
E02003315,4702,100,2925,62.2,2813,59.8,112,2.4,60,1.3,42,0.9,18,0.4,1717,36.5
E02003316,9552,100,6189,64.8,5948,62.3,241,2.5,165,1.7,112,1.2,53,0.6,3198,33.5
E02003317,5634,100,3481,61.8,3368,59.8,113,2,103,1.8,75,1.3,28,0.5,2050,36.4
E02003318,4935,100,2996,60.7,2899,58.7,97,2,84,1.7,63,1.3,21,0.4,1855,37.6
E02003319,6431,100,4161,64.7,3914,60.9,247,3.8,101,1.6,74,1.2,27,0.4,2169,33.7
E02003320,7511,100,4857,64.7,4639,61.8,218,2.9,242,3.2,168,2.2,74,1,2412,32.1
E02003321,5033,100,2827,56.2,2632,52.3,195,3.9,96,1.9,68,1.4,28,0.6,2110,41.9
E02003322,6540,100,3685,56.3,3438,52.6,247,3.8,467,7.1,299,4.6,168,2.6,2388,36.5
E02003323,5630,100,3499,62.1,3295,58.5,204,3.6,110,2,79,1.4,31,0.6,2021,35.9
E02003324,7671,100,5098,66.5,4874,63.5,224,2.9,159,2.1,118,1.5,41,0.5,2414,31.5
E02003325,5665,100,3430,60.5,3166,55.9,264,4.7,145,2.6,106,1.9,39,0.7,2090,36.9
E02003326,6101,100,3793,62.2,3557,58.3,236,3.9,124,2,88,1.4,36,0.6,2184,35.8
E02003327,6215,100,3953,63.6,3714,59.8,239,3.8,118,1.9,79,1.3,39,0.6,2144,34.5
E02003328,7876,100,4683,59.5,4277,54.3,406,5.2,197,2.5,140,1.8,57,0.7,2996,38
E02003329,5316,100,3507,66,3304,62.2,203,3.8,149,2.8,124,2.3,25,0.5,1660,31.2
E02003330,5335,100,3476,65.2,3320,62.2,156,2.9,91,1.7,71,1.3,20,0.4,1768,33.1
E02003331,7170,100,4140,57.7,3933,54.9,207,2.9,122,1.7,83,1.2,39,0.5,2908,40.6
E02003332,5084,100,2978,58.6,2829,55.6,149,2.9,98,1.9,73,1.4,25,0.5,2008,39.5
E02003333,5128,100,3089,60.2,2824,55.1,265,5.2,65,1.3,58,1.1,7,0.1,1974,38.5
E02003334,4806,100,2990,62.2,2805,58.4,185,3.8,136,2.8,95,2,41,0.9,1680,35
E02003335,5265,100,3249,61.7,2976,56.5,273,5.2,122,2.3,87,1.7,35,0.7,1894,36
E02003336,5223,100,3032,58.1,2911,55.7,121,2.3,81,1.6,69,1.3,12,0.2,2110,40.4
E02003337,6046,100,3439,56.9,3225,53.3,214,3.5,86,1.4,58,1,28,0.5,2521,41.7
E02003338,5881,100,3564,60.6,3390,57.6,174,3,93,1.6,70,1.2,23,0.4,2224,37.8
E02003339,5241,100,3102,59.2,2985,57,117,2.2,86,1.6,67,1.3,19,0.4,2053,39.2
E02003340,6366,100,3669,57.6,3477,54.6,192,3,106,1.7,87,1.4,19,0.3,2591,40.7
E02003341,5341,100,3433,64.3,3325,62.3,108,2,61,1.1,40,0.7,21,0.4,1847,34.6
E02003342,5225,100,2978,57,2861,54.8,117,2.2,97,1.9,70,1.3,27,0.5,2150,41.1
E02003343,5059,100,2804,55.4,2716,53.7,88,1.7,81,1.6,64,1.3,17,0.3,2174,43
E02003344,5410,100,3310,61.2,3150,58.2,160,3,77,1.4,52,1,25,0.5,2023,37.4
E02003345,4922,100,3250,66,3152,64,98,2,72,1.5,47,1,25,0.5,1600,32.5
E02003346,5759,100,3417,59.3,3304,57.4,113,2,111,1.9,91,1.6,20,0.3,2231,38.7
E02003347,4826,100,3483,72.2,3372,69.9,111,2.3,77,1.6,39,0.8,38,0.8,1266,26.2
E02003348,6756,100,3837,56.8,3748,55.5,89,1.3,116,1.7,88,1.3,28,0.4,2803,41.5
E02003349,6020,100,3530,58.6,3422,56.8,108,1.8,94,1.6,71,1.2,23,0.4,2396,39.8
E02003350,5168,100,3117,60.3,2989,57.8,128,2.5,99,1.9,68,1.3,31,0.6,1952,37.8
E02003351,6295,100,4023,63.9,3864,61.4,159,2.5,76,1.2,54,0.9,22,0.3,2196,34.9
E02003352,4861,100,2818,58,2712,55.8,106,2.2,87,1.8,69,1.4,18,0.4,1956,40.2
E02003353,9658,100,6851,70.9,6639,68.7,212,2.2,142,1.5,105,1.1,37,0.4,2665,27.6
E02003354,8300,100,5828,70.2,5643,68,185,2.2,149,1.8,122,1.5,27,0.3,2323,28
E02003355,5449,100,3794,69.6,3577,65.6,217,4,78,1.4,56,1,22,0.4,1577,28.9
E02003356,5742,100,3700,64.4,3566,62.1,134,2.3,69,1.2,49,0.9,20,0.3,1973,34.4
E02003357,8048,100,5610,69.7,5357,66.6,253,3.1,122,1.5,96,1.2,26,0.3,2316,28.8
E02003358,9498,100,6746,71,6417,67.6,329,3.5,174,1.8,139,1.5,35,0.4,2578,27.1
E02003359,5181,100,3869,74.7,3737,72.1,132,2.5,63,1.2,41,0.8,22,0.4,1249,24.1
E02003360,8902,100,6198,69.6,5945,66.8,253,2.8,166,1.9,115,1.3,51,0.6,2538,28.5
E02003361,5992,100,4144,69.2,3964,66.2,180,3,88,1.5,62,1,26,0.4,1760,29.4
E02003362,5323,100,3523,66.2,3361,63.1,162,3,89,1.7,70,1.3,19,0.4,1711,32.1
E02003363,5714,100,3187,55.8,3112,54.5,75,1.3,105,1.8,80,1.4,25,0.4,2422,42.4
E02003364,5687,100,3851,67.7,3723,65.5,128,2.3,102,1.8,77,1.4,25,0.4,1734,30.5
E02003365,5601,100,3637,64.9,3519,62.8,118,2.1,111,2,88,1.6,23,0.4,1853,33.1
E02003366,5971,100,3948,66.1,3830,64.1,118,2,144,2.4,119,2,25,0.4,1879,31.5
E02003367,5194,100,3275,63.1,3175,61.1,100,1.9,100,1.9,85,1.6,15,0.3,1819,35
E02003368,4758,100,2926,61.5,2843,59.8,83,1.7,65,1.4,57,1.2,8,0.2,1767,37.1
E02003369,5208,100,3149,60.5,3028,58.1,121,2.3,62,1.2,40,0.8,22,0.4,1997,38.3
E02003370,5549,100,3347,60.3,3241,58.4,106,1.9,87,1.6,72,1.3,15,0.3,2115,38.1
E02003371,4887,100,3086,63.1,2988,61.1,98,2,73,1.5,51,1,22,0.5,1728,35.4
E02003372,6332,100,3952,62.4,3799,60,153,2.4,97,1.5,85,1.3,12,0.2,2283,36.1
E02003373,6711,100,4232,63.1,4130,61.5,102,1.5,134,2,112,1.7,22,0.3,2345,34.9
E02003374,4808,100,3217,66.9,3112,64.7,105,2.2,83,1.7,61,1.3,22,0.5,1508,31.4
E02003375,5044,100,3367,66.8,3269,64.8,98,1.9,67,1.3,54,1.1,13,0.3,1610,31.9
E02003376,4840,100,2922,60.4,2808,58,114,2.4,55,1.1,46,1,9,0.2,1863,38.5
E02003377,8343,100,4977,59.7,4832,57.9,145,1.7,103,1.2,81,1,22,0.3,3263,39.1
E02003378,6630,100,4024,60.7,3857,58.2,167,2.5,71,1.1,44,0.7,27,0.4,2535,38.2
E02003379,5638,100,3792,67.3,3682,65.3,110,2,97,1.7,78,1.4,19,0.3,1749,31
E02003380,6713,100,4621,68.8,4464,66.5,157,2.3,105,1.6,81,1.2,24,0.4,1987,29.6
E02003381,4791,100,3094,64.6,3005,62.7,89,1.9,98,2,81,1.7,17,0.4,1599,33.4
E02003382,6056,100,3853,63.6,3704,61.2,149,2.5,100,1.7,79,1.3,21,0.3,2103,34.7
E02003383,5446,100,3759,69,3653,67.1,106,1.9,107,2,92,1.7,15,0.3,1580,29
E02003384,5395,100,3244,60.1,3137,58.1,107,2,66,1.2,50,0.9,16,0.3,2085,38.6
E02003385,9218,100,6631,71.9,6409,69.5,222,2.4,150,1.6,128,1.4,22,0.2,2437,26.4
E02003386,6686,100,4353,65.1,4182,62.5,171,2.6,90,1.3,69,1,21,0.3,2243,33.5
E02003387,7597,100,4635,61,4462,58.7,173,2.3,166,2.2,124,1.6,42,0.6,2796,36.8
E02003388,4910,100,3002,61.1,2906,59.2,96,2,86,1.8,60,1.2,26,0.5,1822,37.1
E02003389,6510,100,3999,61.4,3829,58.8,170,2.6,117,1.8,97,1.5,20,0.3,2394,36.8
E02003390,6115,100,3761,61.5,3648,59.7,113,1.8,108,1.8,83,1.4,25,0.4,2246,36.7
E02003391,6720,100,4292,63.9,4136,61.5,156,2.3,92,1.4,57,0.8,35,0.5,2336,34.8
E02003392,6998,100,4923,70.3,4683,66.9,240,3.4,106,1.5,87,1.2,19,0.3,1969,28.1
E02003393,6599,100,4245,64.3,4110,62.3,135,2,111,1.7,90,1.4,21,0.3,2243,34
E02003394,6621,100,4305,65,4075,61.5,230,3.5,131,2,91,1.4,40,0.6,2185,33
E02003395,9052,100,6648,73.4,6319,69.8,329,3.6,222,2.5,191,2.1,31,0.3,2182,24.1
E02003396,7900,100,5569,70.5,5313,67.3,256,3.2,144,1.8,108,1.4,36,0.5,2187,27.7
E02003397,6378,100,3939,61.8,3723,58.4,216,3.4,130,2,99,1.6,31,0.5,2309,36.2
E02003398,9436,100,5920,62.7,5574,59.1,346,3.7,520,5.5,402,4.3,118,1.3,2996,31.8
E02003400,7827,100,3586,45.8,3429,43.8,157,2,863,11,659,8.4,204,2.6,3378,43.2
E02003401,7404,100,5013,67.7,4708,63.6,305,4.1,122,1.6,100,1.4,22,0.3,2269,30.6
E02003402,9117,100,5937,65.1,5665,62.1,272,3,466,5.1,350,3.8,116,1.3,2714,29.8
E02003403,7464,100,4687,62.8,4426,59.3,261,3.5,120,1.6,77,1,43,0.6,2657,35.6
E02003404,7228,100,2942,40.7,2760,38.2,182,2.5,693,9.6,458,6.3,235,3.3,3593,49.7
E02003405,10159,100,6769,66.6,6350,62.5,419,4.1,243,2.4,161,1.6,82,0.8,3147,31
E02003406,6536,100,4111,62.9,3879,59.3,232,3.5,121,1.9,93,1.4,28,0.4,2304,35.3
E02006939,6118,100,4519,73.9,4252,69.5,267,4.4,178,2.9,135,2.2,43,0.7,1421,23.2
E02006940,7175,100,4716,65.7,4441,61.9,275,3.8,332,4.6,215,3,117,1.6,2127,29.6
E02003407,7833,100,5181,66.1,4848,61.9,333,4.3,150,1.9,85,1.1,65,0.8,2502,31.9
E02003408,8401,100,5366,63.9,4960,59,406,4.8,209,2.5,147,1.7,62,0.7,2826,33.6
E02003409,8104,100,5487,67.7,5157,63.6,330,4.1,141,1.7,90,1.1,51,0.6,2476,30.6
E02003410,9087,100,5242,57.7,4874,53.6,368,4,273,3,210,2.3,63,0.7,3572,39.3
E02003411,9322,100,5634,60.4,5205,55.8,429,4.6,260,2.8,178,1.9,82,0.9,3428,36.8
E02003412,7883,100,5241,66.5,4949,62.8,292,3.7,173,2.2,139,1.8,34,0.4,2469,31.3
E02003414,10071,100,6822,67.7,6375,63.3,447,4.4,287,2.8,195,1.9,92,0.9,2962,29.4
E02003415,10027,100,6155,61.4,5694,56.8,461,4.6,334,3.3,247,2.5,87,0.9,3538,35.3
E02003416,7357,100,4882,66.4,4632,63,250,3.4,181,2.5,151,2.1,30,0.4,2294,31.2
E02003417,9801,100,6494,66.3,6064,61.9,430,4.4,246,2.5,177,1.8,69,0.7,3061,31.2
E02003418,7825,100,5044,64.5,4697,60,347,4.4,177,2.3,131,1.7,46,0.6,2604,33.3
E02003419,6808,100,4403,64.7,4070,59.8,333,4.9,176,2.6,131,1.9,45,0.7,2229,32.7
E02003420,4919,100,3471,70.6,3245,66,226,4.6,121,2.5,92,1.9,29,0.6,1327,27
E02007068,5308,100,3451,65,3206,60.4,245,4.6,144,2.7,117,2.2,27,0.5,1713,32.3
E02007069,6190,100,3785,61.1,3502,56.6,283,4.6,187,3,128,2.1,59,1,2218,35.8
E02003421,4574,100,2752,60.2,2622,57.3,130,2.8,74,1.6,54,1.2,20,0.4,1748,38.2
E02003422,9743,100,5859,60.1,5676,58.3,183,1.9,107,1.1,68,0.7,39,0.4,3777,38.8
E02003423,5101,100,3311,64.9,3114,61,197,3.9,103,2,87,1.7,16,0.3,1687,33.1
E02003424,7733,100,4960,64.1,4773,61.7,187,2.4,77,1,58,0.8,19,0.2,2696,34.9
E02003425,10442,100,7194,68.9,6770,64.8,424,4.1,207,2,163,1.6,44,0.4,3041,29.1
E02003426,7886,100,5089,64.5,4922,62.4,167,2.1,125,1.6,100,1.3,25,0.3,2672,33.9
E02003427,6359,100,4327,68,4098,64.4,229,3.6,121,1.9,106,1.7,15,0.2,1911,30.1
E02003428,7238,100,4563,63,4377,60.5,186,2.6,90,1.2,68,0.9,22,0.3,2585,35.7
E02003429,6290,100,3865,61.4,3712,59,153,2.4,76,1.2,49,0.8,27,0.4,2349,37.3
E02003430,5961,100,3754,63,3593,60.3,161,2.7,79,1.3,56,0.9,23,0.4,2128,35.7
E02003431,5713,100,3700,64.8,3517,61.6,183,3.2,65,1.1,53,0.9,12,0.2,1948,34.1
E02003432,5809,100,4028,69.3,3866,66.6,162,2.8,70,1.2,54,0.9,16,0.3,1711,29.5
E02003433,5203,100,3226,62,3094,59.5,132,2.5,63,1.2,46,0.9,17,0.3,1914,36.8
E02003434,7327,100,4568,62.3,4356,59.5,212,2.9,101,1.4,77,1.1,24,0.3,2658,36.3
E02003435,5773,100,3819,66.2,3661,63.4,158,2.7,66,1.1,48,0.8,18,0.3,1888,32.7
E02003436,7524,100,4619,61.4,4424,58.8,195,2.6,90,1.2,72,1,18,0.2,2815,37.4
E02003437,6017,100,3666,60.9,3524,58.6,142,2.4,107,1.8,75,1.2,32,0.5,2244,37.3
E02003438,8988,100,5074,56.5,4887,54.4,187,2.1,106,1.2,83,0.9,23,0.3,3808,42.4
E02003439,4537,100,2616,57.7,2510,55.3,106,2.3,55,1.2,42,0.9,13,0.3,1866,41.1
E02003440,7360,100,4666,63.4,4533,61.6,133,1.8,128,1.7,95,1.3,33,0.4,2566,34.9
E02003441,6258,100,3739,59.7,3619,57.8,120,1.9,95,1.5,70,1.1,25,0.4,2424,38.7
E02003442,6620,100,4636,70,4499,68,137,2.1,115,1.7,82,1.2,33,0.5,1869,28.2
E02003443,5419,100,3205,59.1,3034,56,171,3.2,65,1.2,50,0.9,15,0.3,2149,39.7
E02003444,7405,100,4695,63.4,4498,60.7,197,2.7,166,2.2,139,1.9,27,0.4,2544,34.4
E02003445,6958,100,4459,64.1,4302,61.8,157,2.3,111,1.6,76,1.1,35,0.5,2388,34.3
E02003446,8191,100,4071,49.7,3920,47.9,151,1.8,497,6.1,347,4.2,150,1.8,3623,44.2
E02003447,8330,100,5679,68.2,5458,65.5,221,2.7,137,1.6,98,1.2,39,0.5,2514,30.2
E02003448,6377,100,4175,65.5,4053,63.6,122,1.9,111,1.7,98,1.5,13,0.2,2091,32.8
E02003449,5968,100,4309,72.2,4157,69.7,152,2.5,90,1.5,61,1,29,0.5,1569,26.3
E02003450,10277,100,7186,69.9,6912,67.3,274,2.7,157,1.5,117,1.1,40,0.4,2934,28.5
E02003451,7976,100,4976,62.4,4775,59.9,201,2.5,107,1.3,81,1,26,0.3,2893,36.3
E02003452,7300,100,5085,69.7,4939,67.7,146,2,131,1.8,91,1.2,40,0.5,2084,28.5
E02003453,5573,100,3553,63.8,3455,62,98,1.8,110,2,81,1.5,29,0.5,1910,34.3
E02003454,7020,100,4425,63,4290,61.1,135,1.9,104,1.5,79,1.1,25,0.4,2491,35.5
E02003455,8243,100,5870,71.2,5716,69.3,154,1.9,80,1,58,0.7,22,0.3,2293,27.8
E02003456,6264,100,4366,69.7,4231,67.5,135,2.2,78,1.2,61,1,17,0.3,1820,29.1
E02003457,8024,100,4858,60.5,4704,58.6,154,1.9,140,1.7,103,1.3,37,0.5,3026,37.7
E02003458,6730,100,4062,60.4,3926,58.3,136,2,138,2.1,106,1.6,32,0.5,2530,37.6
E02003459,7406,100,4404,59.5,4280,57.8,124,1.7,104,1.4,75,1,29,0.4,2898,39.1
E02003460,9411,100,5967,63.4,5800,61.6,167,1.8,142,1.5,99,1.1,43,0.5,3302,35.1
E02003461,6045,100,3521,58.2,3382,55.9,139,2.3,116,1.9,88,1.5,28,0.5,2408,39.8
E02003462,6546,100,4357,66.6,4205,64.2,152,2.3,123,1.9,93,1.4,30,0.5,2066,31.6
E02003463,5639,100,3331,59.1,3150,55.9,181,3.2,117,2.1,89,1.6,28,0.5,2191,38.9
E02003464,5471,100,3373,61.7,3118,57,255,4.7,162,3,107,2,55,1,1936,35.4
E02003465,5217,100,3061,58.7,2936,56.3,125,2.4,82,1.6,67,1.3,15,0.3,2074,39.8
E02003466,6133,100,4209,68.6,3981,64.9,228,3.7,155,2.5,123,2,32,0.5,1769,28.8
E02003467,5289,100,3115,58.9,2929,55.4,186,3.5,169,3.2,129,2.4,40,0.8,2005,37.9
E02003468,6984,100,4311,61.7,4125,59.1,186,2.7,139,2,105,1.5,34,0.5,2534,36.3
E02003469,4726,100,2904,61.4,2783,58.9,121,2.6,85,1.8,66,1.4,19,0.4,1737,36.8
E02003470,4481,100,2582,57.6,2356,52.6,226,5,134,3,81,1.8,53,1.2,1765,39.4
E02003471,5358,100,3275,61.1,3086,57.6,189,3.5,152,2.8,121,2.3,31,0.6,1931,36
E02003472,8375,100,5783,69.1,5380,64.2,403,4.8,327,3.9,274,3.3,53,0.6,2265,27
E02003473,4526,100,2935,64.8,2802,61.9,133,2.9,101,2.2,80,1.8,21,0.5,1490,32.9
E02003474,7017,100,4680,66.7,4449,63.4,231,3.3,220,3.1,193,2.8,27,0.4,2117,30.2
E02003476,6734,100,3968,58.9,3672,54.5,296,4.4,250,3.7,206,3.1,44,0.7,2516,37.4
E02003478,5447,100,3572,65.6,3417,62.7,155,2.8,120,2.2,99,1.8,21,0.4,1755,32.2
E02003479,5926,100,3761,63.5,3520,59.4,241,4.1,194,3.3,161,2.7,33,0.6,1971,33.3
E02003480,6517,100,4575,70.2,4388,67.3,187,2.9,163,2.5,131,2,32,0.5,1779,27.3
E02003481,6333,100,3750,59.2,3443,54.4,307,4.8,222,3.5,162,2.6,60,0.9,2361,37.3
E02003482,6986,100,4698,67.2,4544,65,154,2.2,136,1.9,107,1.5,29,0.4,2152,30.8
E02003483,8557,100,6178,72.2,5940,69.4,238,2.8,253,3,200,2.3,53,0.6,2126,24.8
E02003484,5723,100,3724,65.1,3539,61.8,185,3.2,130,2.3,101,1.8,29,0.5,1869,32.7
E02003485,6544,100,3968,60.6,3766,57.5,202,3.1,130,2,105,1.6,25,0.4,2446,37.4
E02003486,7748,100,5553,71.7,5332,68.8,221,2.9,207,2.7,168,2.2,39,0.5,1988,25.7
E02003487,5944,100,3435,57.8,3265,54.9,170,2.9,130,2.2,107,1.8,23,0.4,2379,40
E02003488,6739,100,4080,60.5,3847,57.1,233,3.5,183,2.7,142,2.1,41,0.6,2476,36.7
E02003489,6175,100,3826,62,3654,59.2,172,2.8,109,1.8,84,1.4,25,0.4,2240,36.3
E02003490,8072,100,5167,64,4846,60,321,4,268,3.3,190,2.4,78,1,2637,32.7
E02007012,5934,100,4279,72.1,4094,69,185,3.1,194,3.3,159,2.7,35,0.6,1461,24.6
E02007013,7047,100,5568,79,5387,76.4,181,2.6,251,3.6,202,2.9,49,0.7,1228,17.4
E02007014,5542,100,3889,70.2,3718,67.1,171,3.1,166,3,143,2.6,23,0.4,1487,26.8
E02007015,7226,100,5420,75,5222,72.3,198,2.7,209,2.9,154,2.1,55,0.8,1597,22.1
E02007016,7008,100,4666,66.6,4492,64.1,174,2.5,144,2.1,112,1.6,32,0.5,2198,31.4
E02003491,6269,100,3865,61.7,3705,59.1,160,2.6,125,2,89,1.4,36,0.6,2279,36.4
E02003492,9193,100,2240,24.4,2104,22.9,136,1.5,1381,15,700,7.6,681,7.4,5572,60.6
E02003493,6600,100,3869,58.6,3736,56.6,133,2,114,1.7,84,1.3,30,0.5,2617,39.7
E02003494,5345,100,3299,61.7,3167,59.3,132,2.5,116,2.2,81,1.5,35,0.7,1930,36.1
E02003495,5748,100,3642,63.4,3478,60.5,164,2.9,121,2.1,87,1.5,34,0.6,1985,34.5
E02003496,6152,100,3413,55.5,3223,52.4,190,3.1,114,1.9,85,1.4,29,0.5,2625,42.7
E02003497,6079,100,3659,60.2,3547,58.3,112,1.8,103,1.7,76,1.3,27,0.4,2317,38.1
E02003498,7103,100,3213,45.2,2981,42,232,3.3,593,8.3,362,5.1,231,3.3,3297,46.4
E02003499,6544,100,3058,46.7,2874,43.9,184,2.8,533,8.1,349,5.3,184,2.8,2953,45.1
E02003500,6420,100,4277,66.6,4091,63.7,186,2.9,295,4.6,205,3.2,90,1.4,1848,28.8
E02003501,6940,100,4672,67.3,4461,64.3,211,3,149,2.1,99,1.4,50,0.7,2119,30.5
E02003502,6263,100,3866,61.7,3650,58.3,216,3.4,109,1.7,79,1.3,30,0.5,2288,36.5
E02003503,7272,100,4379,60.2,4175,57.4,204,2.8,173,2.4,124,1.7,49,0.7,2720,37.4
E02003504,7344,100,4879,66.4,4664,63.5,215,2.9,343,4.7,230,3.1,113,1.5,2122,28.9
E02003505,8094,100,4332,53.5,4079,50.4,253,3.1,991,12.2,669,8.3,322,4,2771,34.2
E02003506,5640,100,4091,72.5,3904,69.2,187,3.3,98,1.7,62,1.1,36,0.6,1451,25.7
E02003507,8006,100,4633,57.9,4406,55,227,2.8,142,1.8,100,1.2,42,0.5,3231,40.4
E02003508,7510,100,4115,54.8,3896,51.9,219,2.9,830,11.1,561,7.5,269,3.6,2565,34.2
E02003509,7741,100,5393,69.7,5126,66.2,267,3.4,159,2.1,125,1.6,34,0.4,2189,28.3
E02003510,7440,100,5047,67.8,4822,64.8,225,3,150,2,110,1.5,40,0.5,2243,30.1
E02003511,6841,100,4520,66.1,4332,63.3,188,2.7,127,1.9,101,1.5,26,0.4,2194,32.1
E02003512,7827,100,4361,55.7,4121,52.7,240,3.1,818,10.5,526,6.7,292,3.7,2648,33.8
E02003513,5326,100,3066,57.6,2918,54.8,148,2.8,96,1.8,73,1.4,23,0.4,2164,40.6
E02003514,7696,100,5425,70.5,5113,66.4,312,4.1,286,3.7,224,2.9,62,0.8,1985,25.8
E02003515,7252,100,3767,51.9,3472,47.9,295,4.1,145,2,102,1.4,43,0.6,3340,46.1
E02003516,7458,100,5373,72,5046,67.7,327,4.4,268,3.6,186,2.5,82,1.1,1817,24.4
E02003517,9886,100,5825,58.9,5410,54.7,415,4.2,621,6.3,421,4.3,200,2,3440,34.8
E02003518,6750,100,4349,64.4,4135,61.3,214,3.2,107,1.6,80,1.2,27,0.4,2294,34
E02003519,7652,100,5486,71.7,5120,66.9,366,4.8,298,3.9,211,2.8,87,1.1,1868,24.4
E02003520,8226,100,4604,56,4274,52,330,4,465,5.7,315,3.8,150,1.8,3157,38.4
E02003521,7284,100,4313,59.2,4081,56,232,3.2,242,3.3,182,2.5,60,0.8,2729,37.5
E02003522,6706,100,4019,59.9,3770,56.2,249,3.7,170,2.5,137,2,33,0.5,2517,37.5
E02003523,8775,100,4678,53.3,4495,51.2,183,2.1,123,1.4,88,1,35,0.4,3974,45.3
E02003524,6242,100,3728,59.7,3492,55.9,236,3.8,129,2.1,100,1.6,29,0.5,2385,38.2
E02003525,5006,100,2990,59.7,2822,56.4,168,3.4,116,2.3,87,1.7,29,0.6,1900,38
E02003526,5734,100,3096,54,3022,52.7,74,1.3,140,2.4,113,2,27,0.5,2498,43.6
E02003527,5143,100,3206,62.3,3064,59.6,142,2.8,95,1.8,82,1.6,13,0.3,1842,35.8
E02003529,6638,100,4303,64.8,4166,62.8,137,2.1,179,2.7,156,2.4,23,0.3,2156,32.5
E02003530,6281,100,3969,63.2,3802,60.5,167,2.7,150,2.4,119,1.9,31,0.5,2162,34.4
E02003531,6464,100,4167,64.5,4027,62.3,140,2.2,141,2.2,107,1.7,34,0.5,2156,33.4
E02003532,6337,100,4201,66.3,4021,63.5,180,2.8,124,2,89,1.4,35,0.6,2012,31.8
E02003533,4578,100,2925,63.9,2747,60,178,3.9,63,1.4,47,1,16,0.3,1590,34.7
E02003534,7072,100,4754,67.2,4557,64.4,197,2.8,201,2.8,161,2.3,40,0.6,2117,29.9
E02003535,7492,100,5162,68.9,4873,65,289,3.9,187,2.5,122,1.6,65,0.9,2143,28.6
E02003536,6089,100,2962,48.6,2661,43.7,301,4.9,180,3,111,1.8,69,1.1,2947,48.4
E02003537,8313,100,5290,63.6,5092,61.3,198,2.4,205,2.5,159,1.9,46,0.6,2818,33.9
E02003538,8216,100,5114,62.2,4813,58.6,301,3.7,322,3.9,226,2.8,96,1.2,2780,33.8
E02003540,7687,100,4545,59.1,4373,56.9,172,2.2,205,2.7,149,1.9,56,0.7,2937,38.2
E02003541,8979,100,3278,36.5,2960,33,318,3.5,946,10.5,599,6.7,347,3.9,4755,53
E02003542,7409,100,4330,58.4,4116,55.6,214,2.9,551,7.4,411,5.5,140,1.9,2528,34.1
E02003543,7683,100,3713,48.3,3508,45.7,205,2.7,853,11.1,604,7.9,249,3.2,3117,40.6
E02003544,5128,100,3555,69.3,3407,66.4,148,2.9,125,2.4,82,1.6,43,0.8,1448,28.2
E02003545,6097,100,3517,57.7,3319,54.4,198,3.2,308,5.1,236,3.9,72,1.2,2272,37.3
E02003546,6722,100,4170,62,3985,59.3,185,2.8,135,2,94,1.4,41,0.6,2417,36
E02003547,7406,100,3869,52.2,3654,49.3,215,2.9,380,5.1,245,3.3,135,1.8,3157,42.6
E02003548,5365,100,3258,60.7,3095,57.7,163,3,259,4.8,203,3.8,56,1,1848,34.4
E02006821,5346,100,3381,63.2,3283,61.4,98,1.8,137,2.6,115,2.2,22,0.4,1828,34.2
E02006975,9328,100,2238,24,2037,21.8,201,2.2,1489,16,678,7.3,811,8.7,5601,60
E02006976,4075,100,1892,46.4,1698,41.7,194,4.8,156,3.8,111,2.7,45,1.1,2027,49.7
E02003549,7400,100,3134,42.4,2995,40.5,139,1.9,445,6,289,3.9,156,2.1,3821,51.6
E02003550,6362,100,3895,61.2,3739,58.8,156,2.5,109,1.7,85,1.3,24,0.4,2358,37.1
E02003551,5579,100,2392,42.9,2243,40.2,149,2.7,306,5.5,188,3.4,118,2.1,2881,51.6
E02003552,5032,100,2935,58.3,2802,55.7,133,2.6,85,1.7,60,1.2,25,0.5,2012,40
E02003553,6028,100,2597,43.1,2418,40.1,179,3,484,8,370,6.1,114,1.9,2947,48.9
E02003554,5137,100,2979,58,2843,55.3,136,2.6,138,2.7,105,2,33,0.6,2020,39.3
E02003555,6879,100,4401,64,4220,61.3,181,2.6,131,1.9,93,1.4,38,0.6,2347,34.1
E02003556,4598,100,2940,63.9,2831,61.6,109,2.4,102,2.2,72,1.6,30,0.7,1556,33.8
E02003557,5956,100,2605,43.7,2503,42,102,1.7,465,7.8,366,6.1,99,1.7,2886,48.5
E02003558,5631,100,3643,64.7,3464,61.5,179,3.2,121,2.1,97,1.7,24,0.4,1867,33.2
E02003559,6275,100,3973,63.3,3858,61.5,115,1.8,126,2,99,1.6,27,0.4,2176,34.7
E02003560,5624,100,3389,60.3,3193,56.8,196,3.5,116,2.1,83,1.5,33,0.6,2119,37.7
E02003561,6947,100,3217,46.3,3011,43.3,206,3,500,7.2,377,5.4,123,1.8,3230,46.5
E02003562,6739,100,4538,67.3,4368,64.8,170,2.5,141,2.1,104,1.5,37,0.5,2060,30.6
E02003563,6389,100,4142,64.8,3950,61.8,192,3,145,2.3,106,1.7,39,0.6,2102,32.9
E02003564,6404,100,3823,59.7,3656,57.1,167,2.6,128,2,82,1.3,46,0.7,2453,38.3
E02003565,6063,100,2954,48.7,2790,46,164,2.7,590,9.7,438,7.2,152,2.5,2519,41.5
E02003566,5138,100,3043,59.2,2910,56.6,133,2.6,83,1.6,50,1,33,0.6,2012,39.2
E02003567,6256,100,3946,63.1,3733,59.7,213,3.4,162,2.6,132,2.1,30,0.5,2148,34.3
E02003568,7120,100,4740,66.6,4509,63.3,231,3.2,289,4.1,238,3.3,51,0.7,2091,29.4
E02003569,6524,100,4549,69.7,4271,65.5,278,4.3,165,2.5,147,2.3,18,0.3,1810,27.7
E02003570,9185,100,4781,52.1,4325,47.1,456,5,647,7,462,5,185,2,3757,40.9
E02003571,8239,100,3472,42.1,3262,39.6,210,2.5,1012,12.3,736,8.9,276,3.3,3755,45.6
E02003572,4998,100,3151,63,3036,60.7,115,2.3,86,1.7,56,1.1,30,0.6,1761,35.2
E02003573,6162,100,3527,57.2,3275,53.1,252,4.1,127,2.1,87,1.4,40,0.6,2508,40.7
E02003574,6375,100,3911,61.3,3761,59,150,2.4,110,1.7,70,1.1,40,0.6,2354,36.9
E02003575,4929,100,2885,58.5,2690,54.6,195,4,100,2,58,1.2,42,0.9,1944,39.4
E02003576,6460,100,4252,65.8,4069,63,183,2.8,120,1.9,80,1.2,40,0.6,2088,32.3
E02003578,5223,100,3384,64.8,3263,62.5,121,2.3,89,1.7,63,1.2,26,0.5,1750,33.5
E02003579,7870,100,5343,67.9,5131,65.2,212,2.7,125,1.6,99,1.3,26,0.3,2402,30.5
E02003580,4699,100,2695,57.4,2479,52.8,216,4.6,86,1.8,50,1.1,36,0.8,1918,40.8
E02007074,7301,100,3352,45.9,3105,42.5,247,3.4,875,12,565,7.7,310,4.2,3074,42.1
E02007075,4847,100,3638,75.1,3483,71.9,155,3.2,151,3.1,130,2.7,21,0.4,1058,21.8
E02003581,6467,100,3894,60.2,3704,57.3,190,2.9,75,1.2,56,0.9,19,0.3,2498,38.6
E02003582,7158,100,3910,54.6,3760,52.5,150,2.1,131,1.8,96,1.3,35,0.5,3117,43.5
E02003583,6425,100,3198,49.8,3047,47.4,151,2.4,83,1.3,68,1.1,15,0.2,3144,48.9
E02003584,5411,100,2872,53.1,2622,48.5,250,4.6,63,1.2,53,1,10,0.2,2476,45.8
E02003585,5749,100,2642,46,2544,44.3,98,1.7,55,1,42,0.7,13,0.2,3052,53.1
E02003586,6372,100,3278,51.4,3105,48.7,173,2.7,74,1.2,55,0.9,19,0.3,3020,47.4
E02003587,6922,100,3735,54,3488,50.4,247,3.6,81,1.2,61,0.9,20,0.3,3106,44.9
E02003588,7642,100,3995,52.3,3782,49.5,213,2.8,93,1.2,69,0.9,24,0.3,3554,46.5
E02003589,6021,100,3707,61.6,3492,58,215,3.6,121,2,91,1.5,30,0.5,2193,36.4
E02003590,6509,100,2717,41.7,2587,39.7,130,2,58,0.9,38,0.6,20,0.3,3734,57.4
E02003591,7751,100,4267,55.1,4091,52.8,176,2.3,119,1.5,97,1.3,22,0.3,3365,43.4
E02003592,8667,100,3550,41,3372,38.9,178,2.1,69,0.8,54,0.6,15,0.2,5048,58.2
E02003593,4655,100,2223,47.8,2146,46.1,77,1.7,70,1.5,54,1.2,16,0.3,2362,50.7
E02003594,7962,100,3963,49.8,3707,46.6,256,3.2,99,1.2,86,1.1,13,0.2,3900,49
E02003595,7038,100,3206,45.6,3061,43.5,145,2.1,54,0.8,39,0.6,15,0.2,3778,53.7
E02003596,7556,100,3527,46.7,3306,43.8,221,2.9,78,1,55,0.7,23,0.3,3951,52.3
E02003597,4941,100,2411,48.8,2306,46.7,105,2.1,41,0.8,36,0.7,5,0.1,2489,50.4
E02003598,6332,100,2881,45.5,2701,42.7,180,2.8,57,0.9,36,0.6,21,0.3,3394,53.6
E02003652,8224,100,5046,61.4,4886,59.4,160,1.9,164,2,132,1.6,32,0.4,3014,36.6
E02003653,5538,100,3309,59.8,3203,57.8,106,1.9,139,2.5,97,1.8,42,0.8,2090,37.7
E02003654,4813,100,2934,61,2850,59.2,84,1.7,56,1.2,39,0.8,17,0.4,1823,37.9
E02003655,8391,100,5365,63.9,5228,62.3,137,1.6,125,1.5,107,1.3,18,0.2,2901,34.6
E02003656,5503,100,3342,60.7,3245,59,97,1.8,56,1,46,0.8,10,0.2,2105,38.3
E02003657,6034,100,3769,62.5,3663,60.7,106,1.8,79,1.3,66,1.1,13,0.2,2186,36.2
E02003658,8000,100,5162,64.5,5011,62.6,151,1.9,99,1.2,71,0.9,28,0.4,2739,34.2
E02003659,7659,100,5025,65.6,4868,63.6,157,2,128,1.7,92,1.2,36,0.5,2506,32.7
E02003660,8755,100,5513,63,5344,61,169,1.9,137,1.6,110,1.3,27,0.3,3105,35.5
E02003661,4917,100,3046,61.9,2946,59.9,100,2,79,1.6,61,1.2,18,0.4,1792,36.4
E02003662,5069,100,3343,65.9,3209,63.3,134,2.6,103,2,87,1.7,16,0.3,1623,32
E02003663,10137,100,7502,74,7210,71.1,292,2.9,185,1.8,140,1.4,45,0.4,2450,24.2
E02003664,6173,100,4125,66.8,3927,63.6,198,3.2,102,1.7,82,1.3,20,0.3,1946,31.5
E02003665,4943,100,3133,63.4,3011,60.9,122,2.5,90,1.8,73,1.5,17,0.3,1720,34.8
E02003666,6229,100,4167,66.9,3985,64,182,2.9,98,1.6,82,1.3,16,0.3,1964,31.5
E02003667,7487,100,5445,72.7,5283,70.6,162,2.2,143,1.9,110,1.5,33,0.4,1899,25.4
E02003668,7108,100,4222,59.4,4095,57.6,127,1.8,106,1.5,82,1.2,24,0.3,2780,39.1
E02003669,5642,100,3585,63.5,3392,60.1,193,3.4,126,2.2,93,1.6,33,0.6,1931,34.2
E02003670,7404,100,5016,67.7,4836,65.3,180,2.4,115,1.6,87,1.2,28,0.4,2273,30.7
E02003671,4693,100,3151,67.1,3008,64.1,143,3,94,2,73,1.6,21,0.4,1448,30.9
E02003672,10005,100,6220,62.2,6041,60.4,179,1.8,161,1.6,125,1.2,36,0.4,3624,36.2
E02003673,7705,100,4679,60.7,4541,58.9,138,1.8,101,1.3,82,1.1,19,0.2,2925,38
E02003674,4509,100,2731,60.6,2649,58.7,82,1.8,49,1.1,43,1,6,0.1,1729,38.3
E02003675,7821,100,5107,65.3,4942,63.2,165,2.1,103,1.3,86,1.1,17,0.2,2611,33.4
E02003676,6724,100,3896,57.9,3770,56.1,126,1.9,87,1.3,68,1,19,0.3,2741,40.8
E02003677,8146,100,5012,61.5,4781,58.7,231,2.8,157,1.9,118,1.4,39,0.5,2977,36.5
E02003678,4677,100,2952,63.1,2839,60.7,113,2.4,94,2,74,1.6,20,0.4,1631,34.9
E02003679,5567,100,3616,65,3445,61.9,171,3.1,85,1.5,68,1.2,17,0.3,1866,33.5
E02003680,8022,100,4765,59.4,4610,57.5,155,1.9,100,1.2,77,1,23,0.3,3157,39.4
E02003681,8287,100,4880,58.9,4731,57.1,149,1.8,137,1.7,114,1.4,23,0.3,3270,39.5
E02003682,6038,100,3803,63,3670,60.8,133,2.2,93,1.5,76,1.3,17,0.3,2142,35.5
E02003683,5584,100,3358,60.1,3236,58,122,2.2,79,1.4,63,1.1,16,0.3,2147,38.4
E02003685,6418,100,3808,59.3,3693,57.5,115,1.8,106,1.7,80,1.2,26,0.4,2504,39
E02003686,6193,100,3642,58.8,3522,56.9,120,1.9,91,1.5,70,1.1,21,0.3,2460,39.7
E02003687,4582,100,2812,61.4,2723,59.4,89,1.9,61,1.3,49,1.1,12,0.3,1709,37.3
E02003688,9677,100,5746,59.4,5532,57.2,214,2.2,176,1.8,137,1.4,39,0.4,3755,38.8
E02003689,7468,100,4372,58.5,4204,56.3,168,2.2,109,1.5,82,1.1,27,0.4,2987,40
E02003690,6230,100,3750,60.2,3615,58,135,2.2,88,1.4,65,1,23,0.4,2392,38.4
E02003691,5828,100,3508,60.2,3368,57.8,140,2.4,62,1.1,49,0.8,13,0.2,2258,38.7
E02003692,7349,100,4460,60.7,4261,58,199,2.7,86,1.2,70,1,16,0.2,2803,38.1
E02003693,6045,100,3696,61.1,3556,58.8,140,2.3,59,1,43,0.7,16,0.3,2290,37.9
E02003694,6782,100,4381,64.6,4159,61.3,222,3.3,84,1.2,66,1,18,0.3,2317,34.2
E02003695,8820,100,5771,65.4,5511,62.5,260,2.9,132,1.5,109,1.2,23,0.3,2917,33.1
E02003696,7153,100,4021,56.2,3873,54.1,148,2.1,115,1.6,76,1.1,39,0.5,3017,42.2
E02003697,5211,100,3184,61.1,3095,59.4,89,1.7,68,1.3,53,1,15,0.3,1959,37.6
E02003698,6924,100,4188,60.5,4083,59,105,1.5,108,1.6,86,1.2,22,0.3,2628,38
E02003699,4810,100,3027,62.9,2909,60.5,118,2.5,56,1.2,41,0.9,15,0.3,1727,35.9
E02003701,9708,100,5787,59.6,5511,56.8,276,2.8,307,3.2,212,2.2,95,1,3614,37.2
E02003702,6857,100,4516,65.9,4398,64.1,118,1.7,62,0.9,52,0.8,10,0.1,2279,33.2
E02003703,7116,100,4768,67,4544,63.9,224,3.1,188,2.6,162,2.3,26,0.4,2160,30.4
E02003704,4696,100,2931,62.4,2842,60.5,89,1.9,76,1.6,64,1.4,12,0.3,1689,36
E02003705,5534,100,3591,64.9,3354,60.6,237,4.3,155,2.8,126,2.3,29,0.5,1788,32.3
E02003706,5343,100,3525,66,3350,62.7,175,3.3,94,1.8,61,1.1,33,0.6,1724,32.3
E02003707,5310,100,3674,69.2,3488,65.7,186,3.5,102,1.9,81,1.5,21,0.4,1534,28.9
E02003708,7508,100,4587,61.1,4235,56.4,352,4.7,211,2.8,182,2.4,29,0.4,2710,36.1
E02003709,4386,100,2839,64.7,2673,60.9,166,3.8,94,2.1,76,1.7,18,0.4,1453,33.1
E02003710,10075,100,6406,63.6,6073,60.3,333,3.3,445,4.4,298,3,147,1.5,3224,32
E02003711,7748,100,5492,70.9,5273,68.1,219,2.8,111,1.4,91,1.2,20,0.3,2145,27.7
E02003712,6594,100,3943,59.8,3758,57,185,2.8,73,1.1,50,0.8,23,0.3,2578,39.1
E02003713,4789,100,2782,58.1,2677,55.9,105,2.2,59,1.2,41,0.9,18,0.4,1948,40.7
E02003714,5454,100,3622,66.4,3473,63.7,149,2.7,79,1.4,58,1.1,21,0.4,1753,32.1
E02003715,5314,100,3180,59.8,3088,58.1,92,1.7,83,1.6,60,1.1,23,0.4,2051,38.6
E02003716,4933,100,2962,60,2849,57.8,113,2.3,43,0.9,32,0.6,11,0.2,1928,39.1
E02003717,7284,100,4287,58.9,4135,56.8,152,2.1,90,1.2,68,0.9,22,0.3,2907,39.9
E02003718,4494,100,2805,62.4,2708,60.3,97,2.2,78,1.7,53,1.2,25,0.6,1611,35.8
E02006823,7239,100,4103,56.7,3980,55,123,1.7,109,1.5,86,1.2,23,0.3,3027,41.8
E02006824,7720,100,4628,59.9,4497,58.3,131,1.7,127,1.6,101,1.3,26,0.3,2965,38.4
E02004356,5941,100,3308,55.7,3154,53.1,154,2.6,119,2,78,1.3,41,0.7,2514,42.3
E02004357,6003,100,3444,57.4,3245,54.1,199,3.3,115,1.9,92,1.5,23,0.4,2444,40.7
E02004358,6469,100,3317,51.3,3160,48.8,157,2.4,108,1.7,78,1.2,30,0.5,3044,47.1
E02004359,6500,100,3149,48.4,2986,45.9,163,2.5,109,1.7,70,1.1,39,0.6,3242,49.9
E02004361,6557,100,3523,53.7,3403,51.9,120,1.8,125,1.9,79,1.2,46,0.7,2909,44.4
E02004362,7079,100,4339,61.3,4132,58.4,207,2.9,193,2.7,127,1.8,66,0.9,2547,36
E02004363,6002,100,3222,53.7,3049,50.8,173,2.9,88,1.5,70,1.2,18,0.3,2692,44.9
E02004364,6897,100,3768,54.6,3590,52.1,178,2.6,122,1.8,91,1.3,31,0.4,3007,43.6
E02004365,7035,100,4282,60.9,3927,55.8,355,5,226,3.2,179,2.5,47,0.7,2527,35.9
E02004366,6741,100,3476,51.6,3246,48.2,230,3.4,127,1.9,101,1.5,26,0.4,3138,46.6
E02004367,6094,100,2243,36.8,2106,34.6,137,2.2,129,2.1,84,1.4,45,0.7,3722,61.1
E02006857,7350,100,3981,54.2,3772,51.3,209,2.8,107,1.5,78,1.1,29,0.4,3262,44.4
E02006858,5897,100,3035,51.5,2858,48.5,177,3,90,1.5,64,1.1,26,0.4,2772,47
E02004368,6700,100,4135,61.7,3995,59.6,140,2.1,112,1.7,81,1.2,31,0.5,2453,36.6
E02004369,8609,100,4359,50.6,4203,48.8,156,1.8,136,1.6,98,1.1,38,0.4,4114,47.8
E02004370,6235,100,3284,52.7,3054,49,230,3.7,103,1.7,71,1.1,32,0.5,2848,45.7
E02004371,5593,100,3255,58.2,3093,55.3,162,2.9,78,1.4,55,1,23,0.4,2260,40.4
E02004372,5345,100,2905,54.3,2627,49.1,278,5.2,78,1.5,45,0.8,33,0.6,2362,44.2
E02004373,7114,100,4133,58.1,3936,55.3,197,2.8,119,1.7,86,1.2,33,0.5,2862,40.2
E02004374,6154,100,3639,59.1,3440,55.9,199,3.2,96,1.6,76,1.2,20,0.3,2419,39.3
E02004375,7038,100,4145,58.9,3884,55.2,261,3.7,109,1.5,84,1.2,25,0.4,2784,39.6
E02004376,5900,100,3601,61,3304,56,297,5,101,1.7,76,1.3,25,0.4,2198,37.3
E02004377,8955,100,5021,56.1,4771,53.3,250,2.8,122,1.4,87,1,35,0.4,3812,42.6
E02004378,7068,100,4161,58.9,3779,53.5,382,5.4,88,1.2,63,0.9,25,0.4,2819,39.9
E02004379,6273,100,3736,59.6,3612,57.6,124,2,92,1.5,64,1,28,0.4,2445,39
E02004380,8076,100,4489,55.6,4353,53.9,136,1.7,153,1.9,112,1.4,41,0.5,3434,42.5
E02004381,7778,100,4604,59.2,4397,56.5,207,2.7,126,1.6,104,1.3,22,0.3,3048,39.2
E02004382,5397,100,2916,54,2822,52.3,94,1.7,66,1.2,42,0.8,24,0.4,2415,44.7
E02004383,6043,100,3402,56.3,3257,53.9,145,2.4,112,1.9,79,1.3,33,0.5,2529,41.9
E02004384,6197,100,3567,57.6,3400,54.9,167,2.7,90,1.5,56,0.9,34,0.5,2540,41
E02004385,6442,100,3549,55.1,3392,52.7,157,2.4,80,1.2,61,0.9,19,0.3,2813,43.7
E02004386,5428,100,3076,56.7,2930,54,146,2.7,85,1.6,61,1.1,24,0.4,2267,41.8
E02004387,4652,100,2788,59.9,2622,56.4,166,3.6,81,1.7,55,1.2,26,0.6,1783,38.3
E02004388,6365,100,3562,56,3362,52.8,200,3.1,100,1.6,82,1.3,18,0.3,2703,42.5
E02004389,8137,100,3769,46.3,3624,44.5,145,1.8,117,1.4,89,1.1,28,0.3,4251,52.2
E02004390,6762,100,3199,47.3,3066,45.3,133,2,80,1.2,63,0.9,17,0.3,3483,51.5
E02004391,5666,100,2867,50.6,2725,48.1,142,2.5,92,1.6,75,1.3,17,0.3,2707,47.8
E02004392,7570,100,4259,56.3,4086,54,173,2.3,83,1.1,72,1,11,0.1,3228,42.6
E02004393,5520,100,2664,48.3,2535,45.9,129,2.3,54,1,39,0.7,15,0.3,2802,50.8
E02004394,6751,100,3670,54.4,3571,52.9,99,1.5,79,1.2,63,0.9,16,0.2,3002,44.5
E02004395,6554,100,3303,50.4,3118,47.6,185,2.8,59,0.9,42,0.6,17,0.3,3192,48.7
E02004396,8054,100,3801,47.2,3677,45.7,124,1.5,79,1,57,0.7,22,0.3,4174,51.8
E02004397,6655,100,3541,53.2,3398,51.1,143,2.1,100,1.5,74,1.1,26,0.4,3014,45.3
E02004398,7337,100,4033,55,3789,51.6,244,3.3,110,1.5,84,1.1,26,0.4,3194,43.5
E02004399,6923,100,3228,46.6,3092,44.7,136,2,96,1.4,71,1,25,0.4,3599,52
E02004400,9474,100,3860,40.7,3725,39.3,135,1.4,101,1.1,71,0.7,30,0.3,5513,58.2
E02004401,6879,100,2867,41.7,2729,39.7,138,2,62,0.9,40,0.6,22,0.3,3950,57.4
E02004402,7771,100,3759,48.4,3526,45.4,233,3,101,1.3,73,0.9,28,0.4,3911,50.3
E02004403,5302,100,3114,58.7,3002,56.6,112,2.1,72,1.4,50,0.9,22,0.4,2116,39.9
E02004404,5304,100,3162,59.6,3068,57.8,94,1.8,53,1,32,0.6,21,0.4,2089,39.4
E02004405,4919,100,2795,56.8,2676,54.4,119,2.4,69,1.4,54,1.1,15,0.3,2055,41.8
E02004406,6274,100,3247,51.8,3154,50.3,93,1.5,87,1.4,67,1.1,20,0.3,2940,46.9
E02004407,6775,100,3776,55.7,3640,53.7,136,2,71,1,47,0.7,24,0.4,2928,43.2
E02004408,6826,100,4238,62.1,4099,60,139,2,116,1.7,87,1.3,29,0.4,2472,36.2
E02004409,4553,100,2557,56.2,2484,54.6,73,1.6,54,1.2,43,0.9,11,0.2,1942,42.7
E02004410,6753,100,3785,56,3700,54.8,85,1.3,61,0.9,52,0.8,9,0.1,2907,43
E02004411,6982,100,4173,59.8,4044,57.9,129,1.8,101,1.4,78,1.1,23,0.3,2708,38.8
E02004412,6743,100,3989,59.2,3856,57.2,133,2,97,1.4,80,1.2,17,0.3,2657,39.4
E02004413,6194,100,3562,57.5,3438,55.5,124,2,80,1.3,65,1,15,0.2,2552,41.2
E02004414,5347,100,3416,63.9,3311,61.9,105,2,85,1.6,72,1.3,13,0.2,1846,34.5
E02004415,5624,100,3251,57.8,3156,56.1,95,1.7,70,1.2,60,1.1,10,0.2,2303,40.9
E02004416,5522,100,3067,55.5,2976,53.9,91,1.6,64,1.2,50,0.9,14,0.3,2391,43.3
E02004417,5462,100,3071,56.2,2971,54.4,100,1.8,85,1.6,59,1.1,26,0.5,2306,42.2
E02004418,4779,100,2642,55.3,2521,52.8,121,2.5,58,1.2,44,0.9,14,0.3,2079,43.5
E02004419,5114,100,2765,54.1,2646,51.7,119,2.3,86,1.7,66,1.3,20,0.4,2263,44.3
E02004420,11526,100,6307,54.7,6113,53,194,1.7,161,1.4,122,1.1,39,0.3,5058,43.9
E02004421,7764,100,4290,55.3,4129,53.2,161,2.1,113,1.5,89,1.1,24,0.3,3361,43.3
E02004422,9296,100,5233,56.3,5041,54.2,192,2.1,152,1.6,115,1.2,37,0.4,3911,42.1
E02004423,6599,100,3230,48.9,3111,47.1,119,1.8,110,1.7,81,1.2,29,0.4,3259,49.4
E02004675,6229,100,3936,63.2,3818,61.3,118,1.9,67,1.1,45,0.7,22,0.4,2226,35.7
E02004676,6723,100,4122,61.3,3995,59.4,127,1.9,104,1.5,87,1.3,17,0.3,2497,37.1
E02004677,6111,100,3774,61.8,3674,60.1,100,1.6,92,1.5,73,1.2,19,0.3,2245,36.7
E02004678,6312,100,3904,61.9,3797,60.2,107,1.7,91,1.4,70,1.1,21,0.3,2317,36.7
E02004679,8825,100,5926,67.2,5755,65.2,171,1.9,122,1.4,96,1.1,26,0.3,2777,31.5
E02004680,6277,100,4655,74.2,4517,72,138,2.2,103,1.6,78,1.2,25,0.4,1519,24.2
E02004681,11368,100,8051,70.8,7680,67.6,371,3.3,219,1.9,156,1.4,63,0.6,3098,27.3
E02004682,6701,100,4569,68.2,4385,65.4,184,2.7,121,1.8,94,1.4,27,0.4,2011,30
E02004683,6664,100,4576,68.7,4352,65.3,224,3.4,111,1.7,86,1.3,25,0.4,1977,29.7
E02004684,9013,100,6394,70.9,6151,68.2,243,2.7,155,1.7,112,1.2,43,0.5,2464,27.3
E02004685,6734,100,4703,69.8,4510,67,193,2.9,86,1.3,73,1.1,13,0.2,1945,28.9
E02004686,7284,100,5064,69.5,4863,66.8,201,2.8,135,1.9,102,1.4,33,0.5,2085,28.6
E02004687,5858,100,3884,66.3,3670,62.6,214,3.7,100,1.7,78,1.3,22,0.4,1874,32
E02004688,6357,100,3941,62,3731,58.7,210,3.3,96,1.5,74,1.2,22,0.3,2320,36.5
E02004689,4788,100,2590,54.1,2534,52.9,56,1.2,83,1.7,60,1.3,23,0.5,2115,44.2
E02004690,6699,100,4486,67,4331,64.7,155,2.3,130,1.9,99,1.5,31,0.5,2083,31.1
E02004691,6687,100,3902,58.4,3799,56.8,103,1.5,93,1.4,71,1.1,22,0.3,2692,40.3
E02004692,6155,100,3301,53.6,3208,52.1,93,1.5,110,1.8,89,1.4,21,0.3,2744,44.6
E02004693,5952,100,3984,66.9,3819,64.2,165,2.8,102,1.7,77,1.3,25,0.4,1866,31.4
E02004694,6109,100,3838,62.8,3743,61.3,95,1.6,90,1.5,72,1.2,18,0.3,2181,35.7
E02004695,6860,100,5149,75.1,4990,72.7,159,2.3,196,2.9,142,2.1,54,0.8,1515,22.1
E02004696,6109,100,3882,63.5,3755,61.5,127,2.1,75,1.2,65,1.1,10,0.2,2152,35.2
E02004697,5571,100,3264,58.6,3163,56.8,101,1.8,78,1.4,61,1.1,17,0.3,2229,40
E02004698,5319,100,3290,61.9,3107,58.4,183,3.4,64,1.2,47,0.9,17,0.3,1965,36.9
E02004699,9039,100,5405,59.8,5255,58.1,150,1.7,158,1.7,117,1.3,41,0.5,3476,38.5
E02004700,5350,100,3939,73.6,3807,71.2,132,2.5,72,1.3,62,1.2,10,0.2,1339,25
E02004702,6561,100,4448,67.8,4285,65.3,163,2.5,90,1.4,74,1.1,16,0.2,2023,30.8
E02004703,10507,100,6151,58.5,5999,57.1,152,1.4,185,1.8,138,1.3,47,0.4,4171,39.7
E02004704,5184,100,3296,63.6,3200,61.7,96,1.9,74,1.4,57,1.1,17,0.3,1814,35
E02004705,7900,100,4722,59.8,4571,57.9,151,1.9,148,1.9,117,1.5,31,0.4,3030,38.4
E02004706,6375,100,3620,56.8,3518,55.2,102,1.6,101,1.6,76,1.2,25,0.4,2654,41.6
E02004707,9361,100,5291,56.5,5129,54.8,162,1.7,141,1.5,102,1.1,39,0.4,3929,42
E02004708,7844,100,4755,60.6,4557,58.1,198,2.5,112,1.4,84,1.1,28,0.4,2977,38
E02004709,7164,100,4359,60.8,4241,59.2,118,1.6,140,2,104,1.5,36,0.5,2665,37.2
E02004710,5467,100,3226,59,3128,57.2,98,1.8,99,1.8,73,1.3,26,0.5,2142,39.2
E02006829,6250,100,3521,56.3,3427,54.8,94,1.5,90,1.4,81,1.3,9,0.1,2639,42.2
E02006838,5930,100,3217,54.2,3103,52.3,114,1.9,50,0.8,39,0.7,11,0.2,2663,44.9
E02004712,6992,100,3875,55.4,3764,53.8,111,1.6,132,1.9,96,1.4,36,0.5,2985,42.7
E02004713,6492,100,3853,59.3,3741,57.6,112,1.7,106,1.6,84,1.3,22,0.3,2533,39
E02004714,6357,100,3768,59.3,3658,57.5,110,1.7,101,1.6,76,1.2,25,0.4,2488,39.1
E02004715,7296,100,4710,64.6,4530,62.1,180,2.5,128,1.8,93,1.3,35,0.5,2458,33.7
E02004716,7054,100,4512,64,4366,61.9,146,2.1,103,1.5,83,1.2,20,0.3,2439,34.6
E02004717,10045,100,6740,67.1,6449,64.2,291,2.9,191,1.9,151,1.5,40,0.4,3114,31
E02004718,7083,100,4921,69.5,4726,66.7,195,2.8,108,1.5,84,1.2,24,0.3,2054,29
E02004719,9404,100,6111,65,5960,63.4,151,1.6,187,2,143,1.5,44,0.5,3106,33
E02004720,9603,100,5840,60.8,5686,59.2,154,1.6,171,1.8,134,1.4,37,0.4,3592,37.4
E02004721,8827,100,6583,74.6,6454,73.1,129,1.5,263,3,204,2.3,59,0.7,1981,22.4
E02004722,5743,100,3358,58.5,3272,57,86,1.5,92,1.6,70,1.2,22,0.4,2293,39.9
E02004723,8117,100,4941,60.9,4810,59.3,131,1.6,177,2.2,126,1.6,51,0.6,2999,36.9
E02004724,7750,100,5226,67.4,5033,64.9,193,2.5,135,1.7,102,1.3,33,0.4,2389,30.8
E02004725,4548,100,2629,57.8,2521,55.4,108,2.4,67,1.5,45,1,22,0.5,1852,40.7
E02004726,5019,100,3111,62,3005,59.9,106,2.1,73,1.5,46,0.9,27,0.5,1835,36.6
E02004727,8013,100,5406,67.5,5250,65.5,156,1.9,189,2.4,156,1.9,33,0.4,2418,30.2
E02004728,7482,100,4630,61.9,4471,59.8,159,2.1,135,1.8,96,1.3,39,0.5,2717,36.3
E02004729,6021,100,3590,59.6,3429,57,161,2.7,86,1.4,68,1.1,18,0.3,2345,38.9
E02004730,7361,100,4117,55.9,4016,54.6,101,1.4,112,1.5,84,1.1,28,0.4,3132,42.5
E02004731,6389,100,3776,59.1,3672,57.5,104,1.6,138,2.2,100,1.6,38,0.6,2475,38.7
E02004732,7283,100,4340,59.6,4219,57.9,121,1.7,126,1.7,100,1.4,26,0.4,2817,38.7
E02004733,6656,100,4020,60.4,3920,58.9,100,1.5,122,1.8,89,1.3,33,0.5,2514,37.8
E02004734,8591,100,5167,60.1,4998,58.2,169,2,132,1.5,107,1.2,25,0.3,3292,38.3
E02004735,6397,100,3523,55.1,3439,53.8,84,1.3,90,1.4,60,0.9,30,0.5,2784,43.5
E02004736,6849,100,3898,56.9,3805,55.6,93,1.4,103,1.5,76,1.1,27,0.4,2848,41.6
E02004737,6127,100,3796,62,3642,59.4,154,2.5,102,1.7,83,1.4,19,0.3,2229,36.4
E02004738,6122,100,3542,57.9,3399,55.5,143,2.3,98,1.6,79,1.3,19,0.3,2482,40.5
E02004739,6317,100,3214,50.9,3141,49.7,73,1.2,88,1.4,65,1,23,0.4,3015,47.7
E02004740,6046,100,3063,50.7,2993,49.5,70,1.2,105,1.7,86,1.4,19,0.3,2878,47.6
E02004741,6199,100,3494,56.4,3343,53.9,151,2.4,102,1.6,78,1.3,24,0.4,2603,42
E02004742,5866,100,3294,56.2,3154,53.8,140,2.4,86,1.5,67,1.1,19,0.3,2486,42.4
E02004743,6027,100,3802,63.1,3667,60.8,135,2.2,111,1.8,85,1.4,26,0.4,2114,35.1
E02004744,7185,100,4850,67.5,4582,63.8,268,3.7,120,1.7,73,1,47,0.7,2215,30.8
E02004745,6952,100,4375,62.9,4151,59.7,224,3.2,119,1.7,88,1.3,31,0.4,2458,35.4
E02004746,9227,100,4938,53.5,4788,51.9,150,1.6,183,2,130,1.4,53,0.6,4106,44.5
E02004747,5235,100,3105,59.3,2968,56.7,137,2.6,94,1.8,75,1.4,19,0.4,2036,38.9
E02004748,7769,100,4500,57.9,4179,53.8,321,4.1,119,1.5,88,1.1,31,0.4,3150,40.5
E02004749,6045,100,3119,51.6,3026,50.1,93,1.5,98,1.6,79,1.3,19,0.3,2828,46.8
E02004750,6695,100,3953,59,3797,56.7,156,2.3,92,1.4,60,0.9,32,0.5,2650,39.6
E02004751,7044,100,4189,59.5,4036,57.3,153,2.2,98,1.4,67,1,31,0.4,2757,39.1
E02004752,6490,100,4022,62,3902,60.1,120,1.8,101,1.6,72,1.1,29,0.4,2367,36.5
E02004753,9608,100,6248,65,6039,62.9,209,2.2,169,1.8,137,1.4,32,0.3,3191,33.2
E02004754,5805,100,3448,59.4,3346,57.6,102,1.8,71,1.2,48,0.8,23,0.4,2286,39.4
E02004755,9684,100,6760,69.8,6527,67.4,233,2.4,188,1.9,157,1.6,31,0.3,2736,28.3
E02004756,7683,100,5139,66.9,4984,64.9,155,2,130,1.7,94,1.2,36,0.5,2414,31.4
E02004757,6497,100,3698,56.9,3576,55,122,1.9,125,1.9,99,1.5,26,0.4,2674,41.2
E02004758,7396,100,4485,60.6,4337,58.6,148,2,122,1.6,98,1.3,24,0.3,2789,37.7
E02004759,6635,100,4114,62,3976,59.9,138,2.1,133,2,99,1.5,34,0.5,2388,36
E02004760,8172,100,5521,67.6,5343,65.4,178,2.2,136,1.7,97,1.2,39,0.5,2515,30.8
E02004761,5310,100,3420,64.4,3327,62.7,93,1.8,94,1.8,77,1.5,17,0.3,1796,33.8
E02004764,7106,100,3748,52.7,3607,50.8,141,2,126,1.8,93,1.3,33,0.5,3232,45.5
E02004765,5136,100,3108,60.5,3026,58.9,82,1.6,104,2,78,1.5,26,0.5,1924,37.5
E02004766,5846,100,3347,57.3,3205,54.8,142,2.4,108,1.8,88,1.5,20,0.3,2391,40.9
E02004767,4435,100,2661,60,2514,56.7,147,3.3,77,1.7,46,1,31,0.7,1697,38.3
E02004768,4345,100,2675,61.6,2561,58.9,114,2.6,72,1.7,62,1.4,10,0.2,1598,36.8
E02004769,4795,100,2854,59.5,2668,55.6,186,3.9,84,1.8,58,1.2,26,0.5,1857,38.7
E02004770,5310,100,3179,59.9,2959,55.7,220,4.1,105,2,87,1.6,18,0.3,2026,38.2
E02004771,6972,100,4117,59.1,3840,55.1,277,4,120,1.7,93,1.3,27,0.4,2735,39.2
E02004772,7868,100,4695,59.7,4542,57.7,153,1.9,153,1.9,118,1.5,35,0.4,3020,38.4
E02004774,8764,100,4422,50.5,4284,48.9,138,1.6,152,1.7,117,1.3,35,0.4,4190,47.8
E02004775,8675,100,5034,58,4828,55.7,206,2.4,185,2.1,144,1.7,41,0.5,3456,39.8
E02004776,5247,100,2481,47.3,2381,45.4,100,1.9,74,1.4,58,1.1,16,0.3,2692,51.3
E02004777,4607,100,2092,45.4,1989,43.2,103,2.2,52,1.1,37,0.8,15,0.3,2463,53.5
E02004778,5455,100,2509,46,2376,43.6,133,2.4,65,1.2,45,0.8,20,0.4,2881,52.8
E02006822,7779,100,4569,58.7,4409,56.7,160,2.1,127,1.6,103,1.3,24,0.3,3083,39.6
E02006830,5258,100,3140,59.7,2976,56.6,164,3.1,91,1.7,65,1.2,26,0.5,2027,38.6
E02006831,5257,100,2945,56,2850,54.2,95,1.8,77,1.5,61,1.2,16,0.3,2235,42.5
E02004779,9379,100,5146,54.9,4991,53.2,155,1.7,115,1.2,93,1,22,0.2,4118,43.9
E02004780,4830,100,2886,59.8,2787,57.7,99,2,55,1.1,48,1,7,0.1,1889,39.1
E02004781,6529,100,4232,64.8,4108,62.9,124,1.9,104,1.6,87,1.3,17,0.3,2193,33.6
E02004782,6389,100,3758,58.8,3596,56.3,162,2.5,74,1.2,55,0.9,19,0.3,2557,40
E02004783,5736,100,3717,64.8,3624,63.2,93,1.6,103,1.8,81,1.4,22,0.4,1916,33.4
E02004784,4897,100,2538,51.8,2465,50.3,73,1.5,77,1.6,64,1.3,13,0.3,2282,46.6
E02004785,4840,100,2519,52,2438,50.4,81,1.7,74,1.5,62,1.3,12,0.2,2247,46.4
E02004786,6711,100,4310,64.2,4169,62.1,141,2.1,121,1.8,105,1.6,16,0.2,2280,34
E02004787,6274,100,3158,50.3,3060,48.8,98,1.6,73,1.2,56,0.9,17,0.3,3043,48.5
E02004788,6046,100,3352,55.4,3231,53.4,121,2,111,1.8,81,1.3,30,0.5,2583,42.7
E02004789,8551,100,4731,55.3,4560,53.3,171,2,131,1.5,115,1.3,16,0.2,3689,43.1
E02004790,6720,100,3909,58.2,3790,56.4,119,1.8,112,1.7,91,1.4,21,0.3,2699,40.2
E02004791,4328,100,2525,58.3,2402,55.5,123,2.8,47,1.1,28,0.6,19,0.4,1756,40.6
E02004792,7165,100,3787,52.9,3665,51.2,122,1.7,79,1.1,67,0.9,12,0.2,3299,46
E02004793,6333,100,3110,49.1,3005,47.4,105,1.7,85,1.3,75,1.2,10,0.2,3138,49.5
E02004794,5786,100,2955,51.1,2883,49.8,72,1.2,103,1.8,87,1.5,16,0.3,2728,47.1
E02004795,7366,100,3675,49.9,3573,48.5,102,1.4,83,1.1,62,0.8,21,0.3,3608,49
E02004796,8429,100,4061,48.2,3937,46.7,124,1.5,123,1.5,98,1.2,25,0.3,4245,50.4
E02004797,6737,100,3909,58,3742,55.5,167,2.5,107,1.6,92,1.4,15,0.2,2721,40.4
E02004798,5049,100,2720,53.9,2593,51.4,127,2.5,96,1.9,78,1.5,18,0.4,2233,44.2
E02004799,6891,100,3329,48.3,3209,46.6,120,1.7,105,1.5,87,1.3,18,0.3,3457,50.2
E02004800,6846,100,2546,37.2,2476,36.2,70,1,80,1.2,58,0.8,22,0.3,4220,61.6
E02004801,6901,100,2764,40.1,2663,38.6,101,1.5,73,1.1,57,0.8,16,0.2,4064,58.9
E02004802,5506,100,3545,64.4,3376,61.3,169,3.1,90,1.6,71,1.3,19,0.3,1871,34
E02004803,5957,100,3799,63.8,3588,60.2,211,3.5,104,1.7,85,1.4,19,0.3,2054,34.5
E02004804,5925,100,3953,66.7,3810,64.3,143,2.4,107,1.8,77,1.3,30,0.5,1865,31.5
E02004805,7131,100,4651,65.2,4498,63.1,153,2.1,143,2,115,1.6,28,0.4,2337,32.8
E02004806,6463,100,4394,68,4242,65.6,152,2.4,123,1.9,78,1.2,45,0.7,1946,30.1
E02004807,7658,100,5008,65.4,4798,62.7,210,2.7,144,1.9,108,1.4,36,0.5,2506,32.7
E02004808,9829,100,7032,71.5,6784,69,248,2.5,200,2,163,1.7,37,0.4,2597,26.4
E02004809,8336,100,5816,69.8,5570,66.8,246,3,141,1.7,94,1.1,47,0.6,2379,28.5
E02004810,6500,100,4667,71.8,4479,68.9,188,2.9,131,2,100,1.5,31,0.5,1702,26.2
E02004811,6748,100,4235,62.8,4065,60.2,170,2.5,120,1.8,88,1.3,32,0.5,2393,35.5
E02004812,5581,100,3739,67,3600,64.5,139,2.5,110,2,82,1.5,28,0.5,1732,31
E02004813,5239,100,3203,61.1,3082,58.8,121,2.3,98,1.9,66,1.3,32,0.6,1938,37
E02004814,5908,100,3789,64.1,3715,62.9,74,1.3,117,2,100,1.7,17,0.3,2002,33.9
E02004815,5609,100,3703,66,3493,62.3,210,3.7,101,1.8,77,1.4,24,0.4,1805,32.2
E02004817,6235,100,3990,64,3872,62.1,118,1.9,106,1.7,91,1.5,15,0.2,2139,34.3
E02004818,8602,100,5344,62.1,5173,60.1,171,2,179,2.1,132,1.5,47,0.5,3079,35.8
E02004819,6567,100,4155,63.3,4040,61.5,115,1.8,110,1.7,94,1.4,16,0.2,2302,35.1
E02004820,5996,100,3775,63,3665,61.1,110,1.8,100,1.7,79,1.3,21,0.4,2121,35.4
E02004821,4280,100,2457,57.4,2390,55.8,67,1.6,47,1.1,35,0.8,12,0.3,1776,41.5
E02004822,6753,100,3969,58.8,3861,57.2,108,1.6,70,1,49,0.7,21,0.3,2714,40.2
E02004823,7235,100,4105,56.7,3992,55.2,113,1.6,113,1.6,89,1.2,24,0.3,3017,41.7
E02004824,5164,100,2544,49.3,2445,47.3,99,1.9,55,1.1,43,0.8,12,0.2,2565,49.7
E02004825,9033,100,5153,57,5013,55.5,140,1.5,127,1.4,101,1.1,26,0.3,3753,41.5
E02004826,7932,100,4831,60.9,4717,59.5,114,1.4,108,1.4,82,1,26,0.3,2993,37.7
E02004827,5848,100,3949,67.5,3870,66.2,79,1.4,116,2,95,1.6,21,0.4,1783,30.5
E02004828,6048,100,3601,59.5,3499,57.9,102,1.7,112,1.9,92,1.5,20,0.3,2335,38.6
E02007076,5741,100,4366,76,4234,73.8,132,2.3,107,1.9,84,1.5,23,0.4,1268,22.1
E02007077,5471,100,4128,75.5,4026,73.6,102,1.9,83,1.5,63,1.2,20,0.4,1260,23
E02007078,4325,100,2593,60,2506,57.9,87,2,66,1.5,50,1.2,16,0.4,1666,38.5
E02004829,4739,100,2993,63.2,2922,61.7,71,1.5,63,1.3,59,1.2,4,0.1,1683,35.5
E02004830,5661,100,3527,62.3,3422,60.4,105,1.9,85,1.5,69,1.2,16,0.3,2049,36.2
E02004831,8457,100,4860,57.5,4732,56,128,1.5,195,2.3,156,1.8,39,0.5,3402,40.2
E02004832,7207,100,3990,55.4,3863,53.6,127,1.8,101,1.4,76,1.1,25,0.3,3116,43.2
E02004833,8274,100,4286,51.8,4119,49.8,167,2,400,4.8,252,3,148,1.8,3588,43.4
E02004834,6365,100,3538,55.6,3371,53,167,2.6,280,4.4,201,3.2,79,1.2,2547,40
E02004835,9011,100,4965,55.1,4792,53.2,173,1.9,395,4.4,255,2.8,140,1.6,3651,40.5
E02004836,5768,100,2199,38.1,2057,35.7,142,2.5,736,12.8,524,9.1,212,3.7,2833,49.1
E02004837,6703,100,3893,58.1,3788,56.5,105,1.6,201,3,166,2.5,35,0.5,2609,38.9
E02004838,7794,100,4710,60.4,4594,58.9,116,1.5,136,1.7,108,1.4,28,0.4,2948,37.8
E02004839,7374,100,4249,57.6,4139,56.1,110,1.5,108,1.5,86,1.2,22,0.3,3017,40.9
E02004840,8464,100,4981,58.8,4826,57,155,1.8,118,1.4,93,1.1,25,0.3,3365,39.8
E02004841,9589,100,6226,64.9,6043,63,183,1.9,170,1.8,145,1.5,25,0.3,3193,33.3
E02004842,9346,100,5745,61.5,5599,59.9,146,1.6,141,1.5,115,1.2,26,0.3,3460,37
E02004996,6737,100,4015,59.6,3880,57.6,135,2,101,1.5,78,1.2,23,0.3,2621,38.9
E02004997,6882,100,3794,55.1,3656,53.1,138,2,93,1.4,66,1,27,0.4,2995,43.5
E02004998,5570,100,3257,58.5,3168,56.9,89,1.6,108,1.9,86,1.5,22,0.4,2205,39.6
E02005000,9639,100,6305,65.4,5931,61.5,374,3.9,213,2.2,160,1.7,53,0.5,3121,32.4
E02005001,7726,100,4774,61.8,4629,59.9,145,1.9,147,1.9,113,1.5,34,0.4,2805,36.3
E02005002,7800,100,4872,62.5,4622,59.3,250,3.2,139,1.8,106,1.4,33,0.4,2789,35.8
E02005003,7011,100,4394,62.7,4137,59,257,3.7,149,2.1,105,1.5,44,0.6,2468,35.2
E02005004,9276,100,6373,68.7,6128,66.1,245,2.6,181,2,128,1.4,53,0.6,2722,29.3
E02005005,8266,100,5235,63.3,5096,61.7,139,1.7,125,1.5,100,1.2,25,0.3,2906,35.2
E02005006,5155,100,2797,54.3,2712,52.6,85,1.6,62,1.2,44,0.9,18,0.3,2296,44.5
E02005007,7696,100,4485,58.3,4343,56.4,142,1.8,115,1.5,83,1.1,32,0.4,3096,40.2
E02005008,7557,100,3754,49.7,3602,47.7,152,2,92,1.2,70,0.9,22,0.3,3711,49.1
E02005009,4995,100,2729,54.6,2625,52.6,104,2.1,88,1.8,60,1.2,28,0.6,2178,43.6
E02007046,5639,100,3176,56.3,3031,53.8,145,2.6,76,1.3,55,1,21,0.4,2387,42.3
E02007047,6835,100,4874,71.3,4679,68.5,195,2.9,166,2.4,128,1.9,38,0.6,1795,26.3
E02005010,6347,100,3471,54.7,3246,51.1,225,3.5,116,1.8,90,1.4,26,0.4,2760,43.5
E02005011,6529,100,3003,46,2893,44.3,110,1.7,124,1.9,86,1.3,38,0.6,3402,52.1
E02005012,7443,100,3802,51.1,3635,48.8,167,2.2,169,2.3,129,1.7,40,0.5,3472,46.6
E02005013,6963,100,3457,49.6,3304,47.5,153,2.2,111,1.6,87,1.2,24,0.3,3395,48.8
E02005014,7288,100,3466,47.6,3340,45.8,126,1.7,112,1.5,77,1.1,35,0.5,3710,50.9
E02005015,7694,100,4533,58.9,4385,57,148,1.9,135,1.8,103,1.3,32,0.4,3026,39.3
E02005016,6495,100,3523,54.2,3355,51.7,168,2.6,84,1.3,61,0.9,23,0.4,2888,44.5
E02005017,5629,100,3340,59.3,3178,56.5,162,2.9,83,1.5,71,1.3,12,0.2,2206,39.2
E02005018,7271,100,3834,52.7,3684,50.7,150,2.1,96,1.3,72,1,24,0.3,3341,45.9
E02005019,5393,100,3027,56.1,2894,53.7,133,2.5,64,1.2,52,1,12,0.2,2302,42.7
E02005020,6112,100,3421,56,3270,53.5,151,2.5,112,1.8,82,1.3,30,0.5,2579,42.2
E02005021,9895,100,2831,28.6,2737,27.7,94,0.9,1177,11.9,576,5.8,601,6.1,5887,59.5
E02005022,6965,100,2483,35.6,2318,33.3,165,2.4,868,12.5,598,8.6,270,3.9,3614,51.9
E02005023,7987,100,3277,41,2985,37.4,292,3.7,917,11.5,576,7.2,341,4.3,3793,47.5
E02005025,8660,100,3624,41.8,3468,40,156,1.8,797,9.2,510,5.9,287,3.3,4239,48.9
E02005026,6492,100,3939,60.7,3782,58.3,157,2.4,121,1.9,86,1.3,35,0.5,2432,37.5
E02005027,4661,100,2488,53.4,2405,51.6,83,1.8,69,1.5,49,1.1,20,0.4,2104,45.1
E02006855,5264,100,2994,56.9,2829,53.7,165,3.1,328,6.2,215,4.1,113,2.1,1942,36.9
E02006856,9687,100,4675,48.3,4406,45.5,269,2.8,732,7.6,533,5.5,199,2.1,4280,44.2
E02005028,10173,100,7186,70.6,6820,67,366,3.6,235,2.3,184,1.8,51,0.5,2752,27.1
E02005029,11213,100,8681,77.4,8341,74.4,340,3,174,1.6,121,1.1,53,0.5,2358,21
E02005030,9475,100,6632,70,6342,66.9,290,3.1,193,2,137,1.4,56,0.6,2650,28
E02005031,6295,100,4195,66.6,3965,63,230,3.7,117,1.9,91,1.4,26,0.4,1983,31.5
E02005032,7622,100,5274,69.2,5035,66.1,239,3.1,156,2,131,1.7,25,0.3,2192,28.8
E02005033,5910,100,4055,68.6,3874,65.5,181,3.1,91,1.5,68,1.2,23,0.4,1764,29.8
E02005034,6242,100,3976,63.7,3835,61.4,141,2.3,95,1.5,72,1.2,23,0.4,2171,34.8
E02005035,6674,100,4308,64.5,4128,61.9,180,2.7,102,1.5,81,1.2,21,0.3,2264,33.9
E02005036,5137,100,3234,63,3032,59,202,3.9,86,1.7,67,1.3,19,0.4,1817,35.4
E02005037,5824,100,3323,57.1,3215,55.2,108,1.9,87,1.5,50,0.9,37,0.6,2414,41.4
E02005038,4938,100,2895,58.6,2792,56.5,103,2.1,76,1.5,53,1.1,23,0.5,1967,39.8
E02005039,5464,100,3358,61.5,3214,58.8,144,2.6,82,1.5,59,1.1,23,0.4,2024,37
E02005040,5723,100,3136,54.8,3057,53.4,79,1.4,80,1.4,60,1,20,0.3,2507,43.8
E02005041,6099,100,3398,55.7,3277,53.7,121,2,72,1.2,54,0.9,18,0.3,2629,43.1
E02005042,7684,100,3875,50.4,3692,48,183,2.4,98,1.3,75,1,23,0.3,3711,48.3
E02005043,6136,100,3118,50.8,2967,48.4,151,2.5,60,1,33,0.5,27,0.4,2958,48.2
E02005044,5399,100,2723,50.4,2559,47.4,164,3,52,1,33,0.6,19,0.4,2624,48.6
E02005045,7450,100,4284,57.5,4111,55.2,173,2.3,85,1.1,52,0.7,33,0.4,3081,41.4
E02005046,6940,100,4289,61.8,4124,59.4,165,2.4,113,1.6,80,1.2,33,0.5,2538,36.6
E02005047,6387,100,3271,51.2,3103,48.6,168,2.6,62,1,46,0.7,16,0.3,3054,47.8
E02005048,5675,100,3015,53.1,2903,51.2,112,2,64,1.1,52,0.9,12,0.2,2596,45.7
E02005049,6091,100,2749,45.1,2666,43.8,83,1.4,60,1,41,0.7,19,0.3,3282,53.9
E02005050,8099,100,4591,56.7,4450,54.9,141,1.7,143,1.8,112,1.4,31,0.4,3365,41.5
E02005051,10482,100,6220,59.3,5758,54.9,462,4.4,213,2,154,1.5,59,0.6,4049,38.6
E02005052,6740,100,3668,54.4,3411,50.6,257,3.8,97,1.4,68,1,29,0.4,2975,44.1
E02005053,7228,100,4302,59.5,3933,54.4,369,5.1,112,1.5,83,1.1,29,0.4,2814,38.9
E02005054,5720,100,3170,55.4,3039,53.1,131,2.3,74,1.3,53,0.9,21,0.4,2476,43.3
E02005055,6168,100,3946,64,3652,59.2,294,4.8,126,2,92,1.5,34,0.6,2096,34
E02005056,8257,100,5150,62.4,4714,57.1,436,5.3,185,2.2,142,1.7,43,0.5,2922,35.4
E02005057,8930,100,5735,64.2,5401,60.5,334,3.7,180,2,124,1.4,56,0.6,3015,33.8
E02005058,6109,100,3841,62.9,3606,59,235,3.8,99,1.6,70,1.1,29,0.5,2169,35.5
E02005059,7903,100,5006,63.3,4767,60.3,239,3,151,1.9,113,1.4,38,0.5,2746,34.7
E02005060,6819,100,4208,61.7,4013,58.9,195,2.9,119,1.7,78,1.1,41,0.6,2492,36.5
E02005061,5775,100,3336,57.8,3096,53.6,240,4.2,130,2.3,95,1.6,35,0.6,2309,40
E02005062,5583,100,3383,60.6,3243,58.1,140,2.5,84,1.5,55,1,29,0.5,2116,37.9
E02005063,5750,100,3522,61.3,3364,58.5,158,2.7,81,1.4,55,1,26,0.5,2147,37.3
E02005064,5488,100,3023,55.1,2909,53,114,2.1,77,1.4,57,1,20,0.4,2388,43.5
E02005065,6326,100,3829,60.5,3597,56.9,232,3.7,112,1.8,85,1.3,27,0.4,2385,37.7
E02005066,6537,100,3569,54.6,3460,52.9,109,1.7,110,1.7,75,1.1,35,0.5,2858,43.7
E02005067,4909,100,2927,59.6,2836,57.8,91,1.9,85,1.7,65,1.3,20,0.4,1897,38.6
E02005068,5847,100,3919,67,3823,65.4,96,1.6,90,1.5,80,1.4,10,0.2,1838,31.4
E02005069,7374,100,4654,63.1,4500,61,154,2.1,127,1.7,97,1.3,30,0.4,2593,35.2
E02005070,8066,100,4532,56.2,4408,54.6,124,1.5,158,2,118,1.5,40,0.5,3376,41.9
E02005071,10340,100,6807,65.8,6357,61.5,450,4.4,197,1.9,157,1.5,40,0.4,3336,32.3
E02005072,6476,100,3835,59.2,3715,57.4,120,1.9,110,1.7,78,1.2,32,0.5,2531,39.1
E02005073,10108,100,7016,69.4,6677,66.1,339,3.4,190,1.9,162,1.6,28,0.3,2902,28.7
E02005074,6642,100,3760,56.6,3660,55.1,100,1.5,125,1.9,92,1.4,33,0.5,2757,41.5
E02005075,8672,100,5739,66.2,5487,63.3,252,2.9,148,1.7,109,1.3,39,0.4,2785,32.1
E02005076,7864,100,5347,68,5082,64.6,265,3.4,122,1.6,93,1.2,29,0.4,2395,30.5
E02005077,6492,100,3884,59.8,3692,56.9,192,3,103,1.6,79,1.2,24,0.4,2505,38.6
E02005078,8124,100,4743,58.4,4621,56.9,122,1.5,102,1.3,71,0.9,31,0.4,3279,40.4
E02005079,7268,100,4287,59,4178,57.5,109,1.5,113,1.6,83,1.1,30,0.4,2868,39.5
E02005080,9125,100,5320,58.3,5023,55,297,3.3,118,1.3,85,0.9,33,0.4,3687,40.4
E02005081,5900,100,3250,55.1,3159,53.5,91,1.5,84,1.4,60,1,24,0.4,2566,43.5
E02005082,9464,100,6132,64.8,5979,63.2,153,1.6,108,1.1,78,0.8,30,0.3,3224,34.1
E02005083,6385,100,3887,60.9,3775,59.1,112,1.8,71,1.1,60,0.9,11,0.2,2427,38
E02005084,6137,100,3581,58.4,3454,56.3,127,2.1,78,1.3,58,0.9,20,0.3,2478,40.4
E02005085,6330,100,3970,62.7,3849,60.8,121,1.9,68,1.1,50,0.8,18,0.3,2292,36.2
E02005086,5519,100,3396,61.5,3289,59.6,107,1.9,88,1.6,65,1.2,23,0.4,2035,36.9
E02005087,5872,100,3452,58.8,3313,56.4,139,2.4,81,1.4,65,1.1,16,0.3,2339,39.8
E02005088,7736,100,4426,57.2,4165,53.8,261,3.4,125,1.6,104,1.3,21,0.3,3185,41.2
E02005089,5588,100,3528,63.1,3382,60.5,146,2.6,81,1.4,55,1,26,0.5,1979,35.4
E02005090,5045,100,2546,50.5,2469,48.9,77,1.5,50,1,34,0.7,16,0.3,2449,48.5
E02005091,5594,100,3350,59.9,3231,57.8,119,2.1,61,1.1,54,1,7,0.1,2183,39
E02005093,5118,100,2757,53.9,2657,51.9,100,2,66,1.3,51,1,15,0.3,2295,44.8
E02005094,7801,100,5052,64.8,4908,62.9,144,1.8,87,1.1,60,0.8,27,0.3,2662,34.1
E02005095,6002,100,3509,58.5,3388,56.4,121,2,90,1.5,62,1,28,0.5,2403,40
E02005096,7628,100,4809,63,4643,60.9,166,2.2,99,1.3,76,1,23,0.3,2720,35.7
E02005097,7261,100,4284,59,4151,57.2,133,1.8,112,1.5,94,1.3,18,0.2,2865,39.5
E02005098,8055,100,4593,57,4416,54.8,177,2.2,81,1,61,0.8,20,0.2,3381,42
E02005099,6479,100,3920,60.5,3801,58.7,119,1.8,82,1.3,67,1,15,0.2,2477,38.2
E02005100,7853,100,4905,62.5,4714,60,191,2.4,67,0.9,49,0.6,18,0.2,2881,36.7
E02005101,5718,100,3424,59.9,3337,58.4,87,1.5,52,0.9,42,0.7,10,0.2,2242,39.2
E02006832,4844,100,2969,61.3,2877,59.4,92,1.9,63,1.3,50,1,13,0.3,1812,37.4
E02005102,5321,100,2708,50.9,2618,49.2,90,1.7,79,1.5,61,1.1,18,0.3,2534,47.6
E02005103,8028,100,4927,61.4,4745,59.1,182,2.3,180,2.2,137,1.7,43,0.5,2921,36.4
E02005104,6416,100,3508,54.7,3304,51.5,204,3.2,118,1.8,93,1.4,25,0.4,2790,43.5
E02005105,5831,100,3554,61,3300,56.6,254,4.4,116,2,81,1.4,35,0.6,2161,37.1
E02005106,8024,100,4871,60.7,4627,57.7,244,3,141,1.8,106,1.3,35,0.4,3012,37.5
E02005107,10848,100,6157,56.8,5871,54.1,286,2.6,182,1.7,152,1.4,30,0.3,4509,41.6
E02005109,5867,100,2706,46.1,2604,44.4,102,1.7,92,1.6,56,1,36,0.6,3069,52.3
E02005110,6006,100,3238,53.9,3119,51.9,119,2,61,1,41,0.7,20,0.3,2707,45.1
E02005111,6279,100,2830,45.1,2673,42.6,157,2.5,69,1.1,57,0.9,12,0.2,3380,53.8
E02005112,6155,100,2873,46.7,2746,44.6,127,2.1,78,1.3,53,0.9,25,0.4,3204,52.1
E02005113,6243,100,2896,46.4,2764,44.3,132,2.1,47,0.8,27,0.4,20,0.3,3300,52.9
E02005114,5291,100,2670,50.5,2538,48,132,2.5,51,1,33,0.6,18,0.3,2570,48.6
E02006879,5411,100,3094,57.2,2768,51.2,326,6,85,1.6,65,1.2,20,0.4,2232,41.2
E02006880,5835,100,3378,57.9,3145,53.9,233,4,58,1,36,0.6,22,0.4,2399,41.1
E02005115,4896,100,2819,57.6,2537,51.8,282,5.8,78,1.6,55,1.1,23,0.5,1999,40.8
E02005116,4978,100,2512,50.5,2302,46.2,210,4.2,52,1,35,0.7,17,0.3,2414,48.5
E02005117,5607,100,2978,53.1,2874,51.3,104,1.9,61,1.1,39,0.7,22,0.4,2568,45.8
E02005118,8597,100,5366,62.4,5118,59.5,248,2.9,127,1.5,96,1.1,31,0.4,3104,36.1
E02005119,5295,100,2965,56,2801,52.9,164,3.1,68,1.3,54,1,14,0.3,2262,42.7
E02005120,8415,100,3695,43.9,3327,39.5,368,4.4,42,0.5,30,0.4,12,0.1,4678,55.6
E02005121,10873,100,7373,67.8,7076,65.1,297,2.7,243,2.2,180,1.7,63,0.6,3257,30
E02005122,6421,100,3795,59.1,3685,57.4,110,1.7,79,1.2,58,0.9,21,0.3,2547,39.7
E02005123,10057,100,6402,63.7,6141,61.1,261,2.6,153,1.5,113,1.1,40,0.4,3502,34.8
E02005124,6996,100,4114,58.8,3873,55.4,241,3.4,130,1.9,97,1.4,33,0.5,2752,39.3
E02005125,6633,100,4166,62.8,3978,60,188,2.8,79,1.2,62,0.9,17,0.3,2388,36
E02005126,6637,100,3742,56.4,3596,54.2,146,2.2,95,1.4,78,1.2,17,0.3,2800,42.2
E02005127,7287,100,4287,58.8,4167,57.2,120,1.6,129,1.8,93,1.3,36,0.5,2871,39.4
E02005128,7244,100,4202,58,4019,55.5,183,2.5,101,1.4,76,1,25,0.3,2941,40.6
E02005129,9446,100,5457,57.8,5208,55.1,249,2.6,125,1.3,93,1,32,0.3,3864,40.9
E02005130,7792,100,4702,60.3,4517,58,185,2.4,113,1.5,85,1.1,28,0.4,2977,38.2
E02005131,4844,100,2826,58.3,2711,56,115,2.4,55,1.1,36,0.7,19,0.4,1963,40.5
E02005132,8345,100,4583,54.9,4085,49,498,6,92,1.1,57,0.7,35,0.4,3670,44
E02005133,7444,100,3543,47.6,3421,46,122,1.6,104,1.4,74,1,30,0.4,3797,51
E02005134,6346,100,3876,61.1,3576,56.4,300,4.7,104,1.6,83,1.3,21,0.3,2366,37.3
E02005135,6233,100,3642,58.4,3391,54.4,251,4,112,1.8,82,1.3,30,0.5,2479,39.8
E02005136,6613,100,3701,56,3529,53.4,172,2.6,90,1.4,70,1.1,20,0.3,2822,42.7
E02005137,5919,100,3171,53.6,2917,49.3,254,4.3,90,1.5,60,1,30,0.5,2658,44.9
E02005138,7593,100,3984,52.5,3750,49.4,234,3.1,94,1.2,64,0.8,30,0.4,3515,46.3
E02005139,7809,100,3231,41.4,3091,39.6,140,1.8,92,1.2,74,0.9,18,0.2,4486,57.4
E02005140,6429,100,3127,48.6,3021,47,106,1.6,102,1.6,75,1.2,27,0.4,3200,49.8
E02005141,5981,100,3042,50.9,2891,48.3,151,2.5,99,1.7,67,1.1,32,0.5,2840,47.5
E02005142,6133,100,3064,50,2922,47.6,142,2.3,95,1.5,58,0.9,37,0.6,2974,48.5
E02005143,6616,100,3769,57,3558,53.8,211,3.2,131,2,104,1.6,27,0.4,2716,41.1
E02005144,6894,100,3683,53.4,3412,49.5,271,3.9,135,2,92,1.3,43,0.6,3076,44.6
E02005145,6697,100,3841,57.4,3685,55,156,2.3,91,1.4,66,1,25,0.4,2765,41.3
E02005146,6387,100,3986,62.4,3775,59.1,211,3.3,130,2,98,1.5,32,0.5,2271,35.6
E02005147,7275,100,3940,54.2,3610,49.6,330,4.5,108,1.5,85,1.2,23,0.3,3227,44.4
E02005148,6711,100,3392,50.5,3271,48.7,121,1.8,96,1.4,82,1.2,14,0.2,3223,48
E02005149,9809,100,6587,67.2,6371,65,216,2.2,138,1.4,104,1.1,34,0.3,3084,31.4
E02005150,9340,100,6108,65.4,5900,63.2,208,2.2,99,1.1,63,0.7,36,0.4,3133,33.5
E02005151,10187,100,6374,62.6,6206,60.9,168,1.6,151,1.5,125,1.2,26,0.3,3662,35.9
E02005153,7464,100,4388,58.8,4245,56.9,143,1.9,99,1.3,73,1,26,0.3,2977,39.9
E02005154,9369,100,5551,59.2,5355,57.2,196,2.1,116,1.2,90,1,26,0.3,3702,39.5
E02005155,9546,100,6271,65.7,6089,63.8,182,1.9,196,2.1,149,1.6,47,0.5,3079,32.3
E02005156,6004,100,3357,55.9,3198,53.3,159,2.6,96,1.6,59,1,37,0.6,2551,42.5
E02005157,5366,100,2879,53.7,2738,51,141,2.6,78,1.5,61,1.1,17,0.3,2409,44.9
E02005158,5373,100,3076,57.2,2980,55.5,96,1.8,91,1.7,70,1.3,21,0.4,2206,41.1
E02005159,6225,100,3433,55.1,3324,53.4,109,1.8,98,1.6,73,1.2,25,0.4,2694,43.3
E02005160,9945,100,6493,65.3,6244,62.8,249,2.5,138,1.4,104,1,34,0.3,3314,33.3
E02005161,6845,100,4725,69,4560,66.6,165,2.4,121,1.8,108,1.6,13,0.2,1999,29.2
E02006833,10034,100,6190,61.7,6024,60,166,1.7,133,1.3,108,1.1,25,0.2,3711,37
E02005162,8615,100,5256,61,5092,59.1,164,1.9,128,1.5,101,1.2,27,0.3,3231,37.5
E02005163,6323,100,4146,65.6,3984,63,162,2.6,85,1.3,70,1.1,15,0.2,2092,33.1
E02005164,7016,100,4633,66,4451,63.4,182,2.6,104,1.5,82,1.2,22,0.3,2279,32.5
E02005165,6216,100,3590,57.8,3473,55.9,117,1.9,93,1.5,60,1,33,0.5,2533,40.7
E02005166,5356,100,3326,62.1,3172,59.2,154,2.9,96,1.8,70,1.3,26,0.5,1934,36.1
E02005167,6023,100,3494,58,3373,56,121,2,83,1.4,59,1,24,0.4,2446,40.6
E02005168,5999,100,3854,64.2,3729,62.2,125,2.1,82,1.4,61,1,21,0.4,2063,34.4
E02005169,7622,100,5442,71.4,5158,67.7,284,3.7,111,1.5,91,1.2,20,0.3,2069,27.1
E02005170,7814,100,4997,63.9,4836,61.9,161,2.1,110,1.4,81,1,29,0.4,2707,34.6
E02005171,4922,100,2967,60.3,2853,58,114,2.3,57,1.2,43,0.9,14,0.3,1898,38.6
E02005172,6623,100,3994,60.3,3861,58.3,133,2,72,1.1,59,0.9,13,0.2,2557,38.6
E02005173,6861,100,4147,60.4,3991,58.2,156,2.3,60,0.9,47,0.7,13,0.2,2654,38.7
E02005174,6058,100,3290,54.3,3197,52.8,93,1.5,86,1.4,70,1.2,16,0.3,2682,44.3
E02005175,6952,100,3919,56.4,3787,54.5,132,1.9,57,0.8,40,0.6,17,0.2,2976,42.8
E02005921,5746,100,3719,64.7,3634,63.2,85,1.5,62,1.1,50,0.9,12,0.2,1965,34.2
E02005922,7053,100,5035,71.4,4875,69.1,160,2.3,121,1.7,89,1.3,32,0.5,1897,26.9
E02005923,4724,100,3082,65.2,2932,62.1,150,3.2,100,2.1,82,1.7,18,0.4,1542,32.6
E02005924,10388,100,7478,72,7140,68.7,338,3.3,198,1.9,172,1.7,26,0.3,2712,26.1
E02005925,6738,100,4149,61.6,3927,58.3,222,3.3,139,2.1,105,1.6,34,0.5,2450,36.4
E02005926,7612,100,4380,57.5,4244,55.8,136,1.8,129,1.7,102,1.3,27,0.4,3103,40.8
E02005927,4679,100,3104,66.3,3001,64.1,103,2.2,100,2.1,78,1.7,22,0.5,1475,31.5
E02005928,8732,100,5553,63.6,5424,62.1,129,1.5,127,1.5,98,1.1,29,0.3,3052,35
E02005929,6053,100,3570,59,3480,57.5,90,1.5,65,1.1,48,0.8,17,0.3,2418,39.9
E02005930,7593,100,5003,65.9,4861,64,142,1.9,82,1.1,56,0.7,26,0.3,2508,33
E02005931,8960,100,6314,70.5,6159,68.7,155,1.7,139,1.6,113,1.3,26,0.3,2507,28
E02005932,5417,100,4038,74.5,3916,72.3,122,2.3,122,2.3,111,2,11,0.2,1257,23.2
E02005933,6328,100,4332,68.5,4186,66.2,146,2.3,105,1.7,87,1.4,18,0.3,1891,29.9
E02005934,7273,100,4622,63.6,4465,61.4,157,2.2,98,1.3,79,1.1,19,0.3,2553,35.1
E02005935,7010,100,5093,72.7,4924,70.2,169,2.4,119,1.7,111,1.6,8,0.1,1798,25.6
E02005936,10357,100,6785,65.5,6579,63.5,206,2,146,1.4,113,1.1,33,0.3,3426,33.1
E02005937,5612,100,3258,58.1,3147,56.1,111,2,86,1.5,76,1.4,10,0.2,2268,40.4
E02005938,4672,100,3013,64.5,2910,62.3,103,2.2,81,1.7,63,1.3,18,0.4,1578,33.8
E02005939,5630,100,3558,63.2,3444,61.2,114,2,89,1.6,85,1.5,4,0.1,1983,35.2
E02005940,4991,100,2954,59.2,2853,57.2,101,2,77,1.5,61,1.2,16,0.3,1960,39.3
E02005941,5498,100,3084,56.1,2964,53.9,120,2.2,140,2.5,118,2.1,22,0.4,2274,41.4
E02005942,5273,100,2533,48,2472,46.9,61,1.2,232,4.4,180,3.4,52,1,2508,47.6
E02005943,5952,100,3578,60.1,3427,57.6,151,2.5,199,3.3,152,2.6,47,0.8,2175,36.5
E02005944,6564,100,4209,64.1,4005,61,204,3.1,150,2.3,124,1.9,26,0.4,2205,33.6
E02005945,9576,100,4923,51.4,4765,49.8,158,1.6,534,5.6,388,4.1,146,1.5,4119,43
E02005946,6909,100,4546,65.8,4420,64,126,1.8,203,2.9,163,2.4,40,0.6,2160,31.3
E02005947,17678,100,2770,15.7,2677,15.1,93,0.5,1730,9.8,1433,8.1,297,1.7,13178,74.5
E02005948,5776,100,3035,52.5,2924,50.6,111,1.9,334,5.8,289,5,45,0.8,2407,41.7
E02005949,6435,100,3153,49,2981,46.3,172,2.7,448,7,339,5.3,109,1.7,2834,44
E02005950,10248,100,4181,40.8,4021,39.2,160,1.6,956,9.3,773,7.5,183,1.8,5111,49.9
E02005951,4721,100,2930,62.1,2807,59.5,123,2.6,194,4.1,174,3.7,20,0.4,1597,33.8
E02005953,5183,100,3095,59.7,3014,58.2,81,1.6,259,5,222,4.3,37,0.7,1829,35.3
E02005954,8647,100,5532,64,5302,61.3,230,2.7,237,2.7,197,2.3,40,0.5,2878,33.3
E02005955,8806,100,5619,63.8,5321,60.4,298,3.4,207,2.4,180,2,27,0.3,2980,33.8
E02005956,5152,100,3202,62.2,3026,58.7,176,3.4,116,2.3,95,1.8,21,0.4,1834,35.6
E02005957,5297,100,3418,64.5,3233,61,185,3.5,141,2.7,90,1.7,51,1,1738,32.8
E02007021,7038,100,3956,56.2,3776,53.7,180,2.6,369,5.2,276,3.9,93,1.3,2713,38.5
E02007116,6969,100,4053,58.2,3798,54.5,255,3.7,371,5.3,285,4.1,86,1.2,2545,36.5
E02005958,4465,100,2928,65.6,2832,63.4,96,2.2,51,1.1,33,0.7,18,0.4,1486,33.3
E02005959,4955,100,3020,60.9,2927,59.1,93,1.9,69,1.4,52,1,17,0.3,1866,37.7
E02005960,6235,100,3817,61.2,3708,59.5,109,1.7,92,1.5,77,1.2,15,0.2,2326,37.3
E02005961,5660,100,3478,61.4,3389,59.9,89,1.6,72,1.3,54,1,18,0.3,2110,37.3
E02005962,8242,100,5325,64.6,5159,62.6,166,2,94,1.1,83,1,11,0.1,2823,34.3
E02005963,6694,100,4084,61,3970,59.3,114,1.7,90,1.3,79,1.2,11,0.2,2520,37.6
E02005964,6111,100,3701,60.6,3605,59,96,1.6,96,1.6,82,1.3,14,0.2,2314,37.9
E02005965,4544,100,2843,62.6,2757,60.7,86,1.9,57,1.3,44,1,13,0.3,1644,36.2
E02005966,6503,100,5102,78.5,4976,76.5,126,1.9,100,1.5,82,1.3,18,0.3,1301,20
E02005967,7464,100,5442,72.9,5269,70.6,173,2.3,100,1.3,92,1.2,8,0.1,1922,25.8
E02005968,6479,100,4232,65.3,4086,63.1,146,2.3,96,1.5,81,1.3,15,0.2,2151,33.2
E02005969,7914,100,4935,62.4,4799,60.6,136,1.7,115,1.5,88,1.1,27,0.3,2864,36.2
E02005970,4591,100,3220,70.1,3086,67.2,134,2.9,74,1.6,63,1.4,11,0.2,1297,28.3
E02005971,5178,100,3362,64.9,3279,63.3,83,1.6,95,1.8,76,1.5,19,0.4,1721,33.2
E02005972,9344,100,6266,67.1,6095,65.2,171,1.8,131,1.4,111,1.2,20,0.2,2947,31.5
E02005973,4986,100,2909,58.3,2781,55.8,128,2.6,45,0.9,38,0.8,7,0.1,2032,40.8
E02005974,5212,100,3166,60.7,3051,58.5,115,2.2,70,1.3,45,0.9,25,0.5,1976,37.9
E02005975,6705,100,3850,57.4,3737,55.7,113,1.7,99,1.5,78,1.2,21,0.3,2756,41.1
E02005976,5201,100,2922,56.2,2851,54.8,71,1.4,59,1.1,45,0.9,14,0.3,2220,42.7
E02005977,5009,100,2873,57.4,2779,55.5,94,1.9,50,1,35,0.7,15,0.3,2086,41.6
E02005978,6355,100,3805,59.9,3673,57.8,132,2.1,106,1.7,90,1.4,16,0.3,2444,38.5
E02005979,8556,100,5305,62,5152,60.2,153,1.8,200,2.3,162,1.9,38,0.4,3051,35.7
E02005980,9299,100,5478,58.9,5320,57.2,158,1.7,152,1.6,121,1.3,31,0.3,3669,39.5
E02005981,7056,100,4713,66.8,4605,65.3,108,1.5,86,1.2,72,1,14,0.2,2257,32
E02005982,4683,100,2985,63.7,2909,62.1,76,1.6,56,1.2,48,1,8,0.2,1642,35.1
E02005983,9124,100,5965,65.4,5753,63.1,212,2.3,153,1.7,128,1.4,25,0.3,3006,32.9
E02005984,7396,100,4750,64.2,4627,62.6,123,1.7,112,1.5,85,1.1,27,0.4,2534,34.3
E02005985,6436,100,3882,60.3,3720,57.8,162,2.5,86,1.3,68,1.1,18,0.3,2468,38.3
E02005986,7845,100,4949,63.1,4800,61.2,149,1.9,122,1.6,101,1.3,21,0.3,2774,35.4
E02005987,8127,100,5353,65.9,5196,63.9,157,1.9,132,1.6,112,1.4,20,0.2,2642,32.5
E02005988,7239,100,4808,66.4,4674,64.6,134,1.9,110,1.5,85,1.2,25,0.3,2321,32.1
E02005991,8343,100,5279,63.3,5107,61.2,172,2.1,108,1.3,92,1.1,16,0.2,2956,35.4
E02005992,10911,100,7200,66,7009,64.2,191,1.8,144,1.3,115,1.1,29,0.3,3567,32.7
E02006886,11061,100,7062,63.8,6897,62.4,165,1.5,181,1.6,146,1.3,35,0.3,3818,34.5
E02005993,5985,100,3623,60.5,3512,58.7,111,1.9,64,1.1,58,1,6,0.1,2298,38.4
E02005994,5148,100,3176,61.7,3094,60.1,82,1.6,54,1,40,0.8,14,0.3,1918,37.3
E02005995,5369,100,3101,57.8,3023,56.3,78,1.5,64,1.2,51,0.9,13,0.2,2204,41.1
E02005996,7328,100,4611,62.9,4480,61.1,131,1.8,76,1,54,0.7,22,0.3,2641,36
E02005997,5006,100,2910,58.1,2803,56,107,2.1,51,1,36,0.7,15,0.3,2045,40.9
E02005998,5730,100,3509,61.2,3425,59.8,84,1.5,73,1.3,59,1,14,0.2,2148,37.5
E02005999,5498,100,3376,61.4,3300,60,76,1.4,88,1.6,77,1.4,11,0.2,2034,37
E02006000,9576,100,6190,64.6,6024,62.9,166,1.7,173,1.8,151,1.6,22,0.2,3213,33.6
E02006001,5598,100,3853,68.8,3752,67,101,1.8,89,1.6,78,1.4,11,0.2,1656,29.6
E02006002,9058,100,5552,61.3,5375,59.3,177,2,129,1.4,108,1.2,21,0.2,3377,37.3
E02006003,4888,100,2996,61.3,2896,59.2,100,2,69,1.4,50,1,19,0.4,1823,37.3
E02006004,6376,100,4233,66.4,4140,64.9,93,1.5,77,1.2,59,0.9,18,0.3,2066,32.4
E02006005,7614,100,5734,75.3,5589,73.4,145,1.9,152,2,126,1.7,26,0.3,1728,22.7
E02006006,4631,100,3010,65,2913,62.9,97,2.1,56,1.2,47,1,9,0.2,1565,33.8
E02006007,6013,100,3661,60.9,3561,59.2,100,1.7,65,1.1,49,0.8,16,0.3,2287,38
E02006317,5033,100,3135,62.3,3008,59.8,127,2.5,82,1.6,69,1.4,13,0.3,1816,36.1
E02006318,5621,100,3677,65.4,3529,62.8,148,2.6,54,1,48,0.9,6,0.1,1890,33.6
E02006319,5620,100,3631,64.6,3480,61.9,151,2.7,101,1.8,75,1.3,26,0.5,1888,33.6
E02006320,5610,100,3802,67.8,3610,64.3,192,3.4,82,1.5,63,1.1,19,0.3,1726,30.8
E02006321,5045,100,3316,65.7,3197,63.4,119,2.4,66,1.3,50,1,16,0.3,1663,33
E02006322,5032,100,3341,66.4,3242,64.4,99,2,87,1.7,68,1.4,19,0.4,1604,31.9
E02006323,6021,100,3807,63.2,3655,60.7,152,2.5,70,1.2,60,1,10,0.2,2144,35.6
E02006324,6015,100,4099,68.1,3927,65.3,172,2.9,101,1.7,82,1.4,19,0.3,1815,30.2
E02006325,6997,100,4577,65.4,4410,63,167,2.4,87,1.2,60,0.9,27,0.4,2333,33.3
E02006326,5882,100,3859,65.6,3718,63.2,141,2.4,118,2,93,1.6,25,0.4,1905,32.4
E02006327,5229,100,3176,60.7,3054,58.4,122,2.3,65,1.2,46,0.9,19,0.4,1988,38
E02006328,7606,100,5114,67.2,4882,64.2,232,3.1,112,1.5,89,1.2,23,0.3,2380,31.3
E02006329,5712,100,3272,57.3,3148,55.1,124,2.2,69,1.2,55,1,14,0.2,2371,41.5
E02006330,7783,100,4811,61.8,4622,59.4,189,2.4,112,1.4,90,1.2,22,0.3,2860,36.7
E02006331,5723,100,3451,60.3,3340,58.4,111,1.9,88,1.5,59,1,29,0.5,2184,38.2
E02006332,5349,100,3275,61.2,3156,59,119,2.2,50,0.9,45,0.8,5,0.1,2024,37.8
E02006333,7792,100,4392,56.4,4195,53.8,197,2.5,93,1.2,66,0.8,27,0.3,3307,42.4
E02006334,6702,100,3765,56.2,3649,54.4,116,1.7,62,0.9,40,0.6,22,0.3,2875,42.9
E02006335,6552,100,3999,61,3837,58.6,162,2.5,107,1.6,85,1.3,22,0.3,2446,37.3
E02006336,5609,100,3707,66.1,3560,63.5,147,2.6,90,1.6,63,1.1,27,0.5,1812,32.3
E02006337,7161,100,4436,61.9,4296,60,140,2,113,1.6,85,1.2,28,0.4,2612,36.5
E02006338,5422,100,3408,62.9,3289,60.7,119,2.2,80,1.5,60,1.1,20,0.4,1934,35.7
E02006339,8281,100,5663,68.4,5439,65.7,224,2.7,128,1.5,94,1.1,34,0.4,2490,30.1
E02006341,8230,100,5120,62.2,4905,59.6,215,2.6,199,2.4,147,1.8,52,0.6,2911,35.4
E02006342,6720,100,4062,60.4,3876,57.7,186,2.8,176,2.6,127,1.9,49,0.7,2482,36.9
E02006343,7080,100,4400,62.1,4301,60.7,99,1.4,137,1.9,88,1.2,49,0.7,2543,35.9
E02006837,9547,100,5742,60.1,5541,58,201,2.1,144,1.5,112,1.2,32,0.3,3661,38.3
E02006344,7094,100,4105,57.9,3988,56.2,117,1.6,131,1.8,89,1.3,42,0.6,2858,40.3
E02006345,6444,100,4198,65.1,4060,63,138,2.1,113,1.8,94,1.5,19,0.3,2133,33.1
E02006346,8048,100,4548,56.5,4396,54.6,152,1.9,123,1.5,97,1.2,26,0.3,3377,42
E02006347,5882,100,3842,65.3,3731,63.4,111,1.9,57,1,45,0.8,12,0.2,1983,33.7
E02006348,7018,100,4192,59.7,4059,57.8,133,1.9,145,2.1,106,1.5,39,0.6,2681,38.2
E02006349,6508,100,4122,63.3,3937,60.5,185,2.8,272,4.2,204,3.1,68,1,2114,32.5
E02006350,5146,100,3223,62.6,3073,59.7,150,2.9,175,3.4,131,2.5,44,0.9,1748,34
E02006351,6572,100,4309,65.6,4174,63.5,135,2.1,119,1.8,91,1.4,28,0.4,2144,32.6
E02006352,5173,100,2881,55.7,2790,53.9,91,1.8,326,6.3,243,4.7,83,1.6,1966,38
E02006353,4988,100,3100,62.1,2976,59.7,124,2.5,90,1.8,74,1.5,16,0.3,1798,36
E02006354,7680,100,4554,59.3,4419,57.5,135,1.8,155,2,131,1.7,24,0.3,2971,38.7
E02006355,8659,100,2990,34.5,2809,32.4,181,2.1,963,11.1,627,7.2,336,3.9,4706,54.3
E02006356,9904,100,6457,65.2,6196,62.6,261,2.6,427,4.3,335,3.4,92,0.9,3020,30.5
E02006357,5890,100,3933,66.8,3825,64.9,108,1.8,91,1.5,75,1.3,16,0.3,1866,31.7
E02006358,7900,100,3013,38.1,2895,36.6,118,1.5,869,11,579,7.3,290,3.7,4018,50.9
E02006359,5088,100,2960,58.2,2856,56.1,104,2,135,2.7,101,2,34,0.7,1993,39.2
E02006360,6655,100,3960,59.5,3820,57.4,140,2.1,85,1.3,70,1.1,15,0.2,2610,39.2
E02006361,4714,100,2703,57.3,2630,55.8,73,1.5,66,1.4,50,1.1,16,0.3,1945,41.3
E02006362,5556,100,3174,57.1,3085,55.5,89,1.6,92,1.7,74,1.3,18,0.3,2290,41.2
E02006363,4853,100,2825,58.2,2739,56.4,86,1.8,68,1.4,56,1.2,12,0.2,1960,40.4
E02006364,6207,100,4232,68.2,4028,64.9,204,3.3,84,1.4,68,1.1,16,0.3,1891,30.5
E02006365,5283,100,3023,57.2,2908,55,115,2.2,67,1.3,56,1.1,11,0.2,2193,41.5
E02006366,6614,100,3860,58.4,3733,56.4,127,1.9,111,1.7,91,1.4,20,0.3,2643,40
E02006367,4930,100,2657,53.9,2564,52,93,1.9,82,1.7,70,1.4,12,0.2,2191,44.4
E02006368,4720,100,2543,53.9,2466,52.2,77,1.6,64,1.4,45,1,19,0.4,2113,44.8
E02006369,5439,100,2994,55,2905,53.4,89,1.6,61,1.1,41,0.8,20,0.4,2384,43.8
E02006370,5328,100,3384,63.5,3264,61.3,120,2.3,68,1.3,52,1,16,0.3,1876,35.2
E02006371,6091,100,3744,61.5,3621,59.4,123,2,87,1.4,72,1.2,15,0.2,2260,37.1
E02006372,5151,100,3226,62.6,3105,60.3,121,2.3,75,1.5,58,1.1,17,0.3,1850,35.9
E02006373,6248,100,3816,61.1,3688,59,128,2,88,1.4,73,1.2,15,0.2,2344,37.5
E02006374,5909,100,3533,59.8,3427,58,106,1.8,64,1.1,48,0.8,16,0.3,2312,39.1
E02006375,5450,100,3390,62.2,3288,60.3,102,1.9,86,1.6,58,1.1,28,0.5,1974,36.2
E02006376,7825,100,3883,49.6,3686,47.1,197,2.5,99,1.3,87,1.1,12,0.2,3843,49.1
E02006377,5117,100,2936,57.4,2838,55.5,98,1.9,83,1.6,67,1.3,16,0.3,2098,41
E02006378,7106,100,4563,64.2,4413,62.1,150,2.1,103,1.4,77,1.1,26,0.4,2440,34.3
E02006379,5215,100,3448,66.1,3281,62.9,167,3.2,93,1.8,58,1.1,35,0.7,1674,32.1
E02006380,5903,100,3311,56.1,3238,54.9,73,1.2,84,1.4,66,1.1,18,0.3,2508,42.5
E02006381,6017,100,3504,58.2,3393,56.4,111,1.8,64,1.1,54,0.9,10,0.2,2449,40.7
E02006382,5263,100,3508,66.7,3341,63.5,167,3.2,83,1.6,64,1.2,19,0.4,1672,31.8
E02006383,8005,100,4942,61.7,4783,59.8,159,2,113,1.4,81,1,32,0.4,2950,36.9
E02006384,8622,100,5620,65.2,5360,62.2,260,3,167,1.9,143,1.7,24,0.3,2835,32.9
E02006385,8985,100,6544,72.8,6311,70.2,233,2.6,148,1.6,115,1.3,33,0.4,2293,25.5
E02006386,6456,100,4208,65.2,4074,63.1,134,2.1,135,2.1,108,1.7,27,0.4,2113,32.7
E02006387,5203,100,3307,63.6,3181,61.1,126,2.4,102,2,78,1.5,24,0.5,1794,34.5
E02006388,7486,100,5137,68.6,4959,66.2,178,2.4,175,2.3,133,1.8,42,0.6,2174,29
E02006389,5815,100,3655,62.9,3523,60.6,132,2.3,101,1.7,81,1.4,20,0.3,2059,35.4
E02006390,8110,100,5527,68.2,5315,65.5,212,2.6,89,1.1,63,0.8,26,0.3,2494,30.8
E02006391,6045,100,4218,69.8,4081,67.5,137,2.3,99,1.6,77,1.3,22,0.4,1728,28.6
E02006392,7512,100,4847,64.5,4575,60.9,272,3.6,110,1.5,86,1.1,24,0.3,2555,34
E02006393,6019,100,2968,49.3,2806,46.6,162,2.7,570,9.5,421,7,149,2.5,2481,41.2
E02006394,10462,100,3556,34,3360,32.1,196,1.9,1280,12.2,824,7.9,456,4.4,5626,53.8
E02006395,7875,100,5267,66.9,4970,63.1,297,3.8,144,1.8,110,1.4,34,0.4,2464,31.3
E02006396,5028,100,2945,58.6,2820,56.1,125,2.5,80,1.6,64,1.3,16,0.3,2003,39.8
E02006397,5182,100,2998,57.9,2886,55.7,112,2.2,81,1.6,66,1.3,15,0.3,2103,40.6
E02006398,6959,100,4835,69.5,4612,66.3,223,3.2,100,1.4,70,1,30,0.4,2024,29.1
E02006399,9833,100,6494,66,6247,63.5,247,2.5,140,1.4,112,1.1,28,0.3,3199,32.5
E02006400,4700,100,2854,60.7,2747,58.4,107,2.3,48,1,33,0.7,15,0.3,1798,38.3
E02006401,8564,100,5428,63.4,5216,60.9,212,2.5,140,1.6,102,1.2,38,0.4,2996,35
E02006402,8091,100,5032,62.2,4874,60.2,158,2,138,1.7,116,1.4,22,0.3,2921,36.1
E02006403,5385,100,3539,65.7,3278,60.9,261,4.8,65,1.2,45,0.8,20,0.4,1781,33.1
E02006404,5945,100,3875,65.2,3652,61.4,223,3.8,109,1.8,78,1.3,31,0.5,1961,33
E02006405,9282,100,6072,65.4,5795,62.4,277,3,136,1.5,109,1.2,27,0.3,3074,33.1
E02006406,7465,100,5139,68.8,4837,64.8,302,4,151,2,113,1.5,38,0.5,2175,29.1
E02006407,7541,100,4787,63.5,4575,60.7,212,2.8,128,1.7,82,1.1,46,0.6,2626,34.8
E02006408,7138,100,4780,67,4567,64,213,3,130,1.8,98,1.4,32,0.4,2228,31.2
E02006409,5427,100,3433,63.3,3252,59.9,181,3.3,100,1.8,59,1.1,41,0.8,1894,34.9
E02006410,6663,100,4311,64.7,4075,61.2,236,3.5,158,2.4,117,1.8,41,0.6,2194,32.9
E02006411,5996,100,3723,62.1,3568,59.5,155,2.6,86,1.4,60,1,26,0.4,2187,36.5
E02006412,6246,100,3918,62.7,3743,59.9,175,2.8,94,1.5,76,1.2,18,0.3,2234,35.8
E02006413,5291,100,3176,60,3027,57.2,149,2.8,69,1.3,52,1,17,0.3,2046,38.7
E02006414,5074,100,3114,61.4,2996,59,118,2.3,81,1.6,42,0.8,39,0.8,1879,37
E02006415,5910,100,3300,55.8,3180,53.8,120,2,88,1.5,71,1.2,17,0.3,2522,42.7
E02006416,6926,100,4072,58.8,3929,56.7,143,2.1,91,1.3,70,1,21,0.3,2763,39.9
E02006417,4901,100,3134,63.9,3015,61.5,119,2.4,68,1.4,52,1.1,16,0.3,1699,34.7
E02006418,5547,100,3331,60.1,3236,58.3,95,1.7,95,1.7,70,1.3,25,0.5,2121,38.2
E02006419,6639,100,4279,64.5,4052,61,227,3.4,138,2.1,113,1.7,25,0.4,2222,33.5
E02006420,6508,100,3849,59.1,3713,57.1,136,2.1,124,1.9,98,1.5,26,0.4,2535,39
E02006421,8188,100,5132,62.7,4962,60.6,170,2.1,151,1.8,101,1.2,50,0.6,2905,35.5
E02006422,4932,100,3137,63.6,3036,61.6,101,2,111,2.3,84,1.7,27,0.5,1684,34.1
E02006423,9274,100,5959,64.3,5629,60.7,330,3.6,154,1.7,127,1.4,27,0.3,3161,34.1
E02006424,5279,100,3185,60.3,3071,58.2,114,2.2,91,1.7,70,1.3,21,0.4,2003,37.9
E02006425,5228,100,3310,63.3,3198,61.2,112,2.1,72,1.4,56,1.1,16,0.3,1846,35.3
E02006426,4500,100,2918,64.8,2819,62.6,99,2.2,76,1.7,56,1.2,20,0.4,1506,33.5
E02006427,5863,100,3888,66.3,3749,63.9,139,2.4,84,1.4,59,1,25,0.4,1891,32.3
E02006429,6647,100,4454,67,4279,64.4,175,2.6,84,1.3,67,1,17,0.3,2109,31.7
E02006430,7458,100,4893,65.6,4697,63,196,2.6,120,1.6,95,1.3,25,0.3,2445,32.8
E02006431,8982,100,5571,62,5352,59.6,219,2.4,126,1.4,94,1,32,0.4,3285,36.6
E02006432,4632,100,2689,58.1,2591,55.9,98,2.1,69,1.5,55,1.2,14,0.3,1874,40.5
E02006433,7721,100,4571,59.2,4442,57.5,129,1.7,125,1.6,97,1.3,28,0.4,3025,39.2
E02006434,5215,100,3245,62.2,3114,59.7,131,2.5,79,1.5,57,1.1,22,0.4,1891,36.3
E02006435,4950,100,3045,61.5,2918,58.9,127,2.6,49,1,40,0.8,9,0.2,1856,37.5
E02006436,5014,100,3138,62.6,3003,59.9,135,2.7,61,1.2,48,1,13,0.3,1815,36.2
E02006437,6923,100,4061,58.7,3931,56.8,130,1.9,87,1.3,54,0.8,33,0.5,2775,40.1
E02006438,6996,100,4161,59.5,4003,57.2,158,2.3,90,1.3,73,1,17,0.2,2745,39.2
E02006790,6297,100,3651,58,3506,55.7,145,2.3,89,1.4,67,1.1,22,0.3,2557,40.6
E02006439,5104,100,3211,62.9,3124,61.2,87,1.7,83,1.6,70,1.4,13,0.3,1810,35.5
E02006440,5873,100,3631,61.8,3494,59.5,137,2.3,150,2.6,110,1.9,40,0.7,2092,35.6
E02006441,7075,100,3794,53.6,3629,51.3,165,2.3,255,3.6,168,2.4,87,1.2,3026,42.8
E02006442,5029,100,2782,55.3,2702,53.7,80,1.6,90,1.8,70,1.4,20,0.4,2157,42.9
E02006443,6052,100,3918,64.7,3785,62.5,133,2.2,90,1.5,72,1.2,18,0.3,2044,33.8
E02006444,5526,100,3368,60.9,3269,59.2,99,1.8,130,2.4,99,1.8,31,0.6,2028,36.7
E02006445,6738,100,4261,63.2,4129,61.3,132,2,86,1.3,72,1.1,14,0.2,2391,35.5
E02006446,5615,100,3216,57.3,3127,55.7,89,1.6,63,1.1,47,0.8,16,0.3,2336,41.6
E02006447,5289,100,3169,59.9,3069,58,100,1.9,108,2,89,1.7,19,0.4,2012,38
E02006448,5828,100,3642,62.5,3515,60.3,127,2.2,97,1.7,75,1.3,22,0.4,2089,35.8
E02006449,5666,100,3367,59.4,3268,57.7,99,1.7,80,1.4,60,1.1,20,0.4,2219,39.2
E02006450,5751,100,3531,61.4,3430,59.6,101,1.8,104,1.8,74,1.3,30,0.5,2116,36.8
E02006451,9579,100,5327,55.6,5167,53.9,160,1.7,118,1.2,94,1,24,0.3,4134,43.2
E02006453,7000,100,3783,54,3674,52.5,109,1.6,105,1.5,81,1.2,24,0.3,3112,44.5
E02006454,5411,100,3259,60.2,3109,57.5,150,2.8,42,0.8,30,0.6,12,0.2,2110,39
E02006455,5002,100,3064,61.3,2958,59.1,106,2.1,60,1.2,52,1,8,0.2,1878,37.5
E02006839,7092,100,4018,56.7,3913,55.2,105,1.5,109,1.5,90,1.3,19,0.3,2965,41.8
E02006456,6424,100,4186,65.2,4021,62.6,165,2.6,108,1.7,91,1.4,17,0.3,2130,33.2
E02006457,7554,100,4461,59.1,4316,57.1,145,1.9,114,1.5,97,1.3,17,0.2,2979,39.4
E02006458,7394,100,4433,60,4283,57.9,150,2,136,1.8,93,1.3,43,0.6,2825,38.2
E02006459,8291,100,5268,63.5,4946,59.7,322,3.9,265,3.2,206,2.5,59,0.7,2758,33.3
E02006460,7346,100,4818,65.6,4624,62.9,194,2.6,136,1.9,107,1.5,29,0.4,2392,32.6
E02006461,5594,100,3439,61.5,3308,59.1,131,2.3,108,1.9,93,1.7,15,0.3,2047,36.6
E02006462,6675,100,4473,67,4301,64.4,172,2.6,121,1.8,93,1.4,28,0.4,2081,31.2
E02006463,8794,100,6320,71.9,6052,68.8,268,3,138,1.6,123,1.4,15,0.2,2336,26.6
E02006464,5493,100,3555,64.7,3428,62.4,127,2.3,81,1.5,62,1.1,19,0.3,1857,33.8
E02006465,5043,100,3150,62.5,3045,60.4,105,2.1,101,2,84,1.7,17,0.3,1792,35.5
E02006466,8617,100,5830,67.7,5563,64.6,267,3.1,153,1.8,102,1.2,51,0.6,2634,30.6
E02006467,5748,100,3755,65.3,3639,63.3,116,2,81,1.4,58,1,23,0.4,1912,33.3
E02006534,7401,100,4366,59,4201,56.8,165,2.2,135,1.8,97,1.3,38,0.5,2900,39.2
E02006535,5894,100,3411,57.9,3296,55.9,115,2,93,1.6,63,1.1,30,0.5,2390,40.5
E02006536,6062,100,3618,59.7,3498,57.7,120,2,99,1.6,72,1.2,27,0.4,2345,38.7
E02006537,8383,100,4810,57.4,4581,54.6,229,2.7,144,1.7,107,1.3,37,0.4,3429,40.9
E02006538,7740,100,4550,58.8,4363,56.4,187,2.4,104,1.3,86,1.1,18,0.2,3086,39.9
E02006539,6085,100,3426,56.3,3275,53.8,151,2.5,84,1.4,69,1.1,15,0.2,2575,42.3
E02006540,4796,100,2620,54.6,2483,51.8,137,2.9,46,1,35,0.7,11,0.2,2130,44.4
E02006541,6587,100,3685,55.9,3540,53.7,145,2.2,76,1.2,56,0.9,20,0.3,2826,42.9
E02006542,5014,100,2662,53.1,2587,51.6,75,1.5,106,2.1,96,1.9,10,0.2,2246,44.8
E02006543,4829,100,2619,54.2,2519,52.2,100,2.1,78,1.6,61,1.3,17,0.4,2132,44.1
E02006544,9697,100,5566,57.4,5402,55.7,164,1.7,155,1.6,115,1.2,40,0.4,3976,41
E02006545,9252,100,5887,63.6,5611,60.6,276,3,211,2.3,166,1.8,45,0.5,3154,34.1
E02006546,9120,100,4951,54.3,4767,52.3,184,2,199,2.2,158,1.7,41,0.4,3970,43.5
E02006547,5750,100,3147,54.7,2984,51.9,163,2.8,103,1.8,77,1.3,26,0.5,2500,43.5
E02006548,8056,100,4751,59,4556,56.6,195,2.4,152,1.9,122,1.5,30,0.4,3153,39.1
E02006549,5681,100,2275,40,2174,38.3,101,1.8,61,1.1,42,0.7,19,0.3,3345,58.9
E02006550,8269,100,4108,49.7,3943,47.7,165,2,142,1.7,106,1.3,36,0.4,4019,48.6
E02006551,7391,100,2561,34.7,2465,33.4,96,1.3,71,1,52,0.7,19,0.3,4759,64.4
E02006552,6254,100,3630,58,3369,53.9,261,4.2,82,1.3,53,0.8,29,0.5,2542,40.6
E02006553,7850,100,4972,63.3,4793,61.1,179,2.3,142,1.8,112,1.4,30,0.4,2736,34.9
E02006554,5762,100,2808,48.7,2711,47,97,1.7,82,1.4,68,1.2,14,0.2,2872,49.8
E02006555,6365,100,3752,58.9,3589,56.4,163,2.6,157,2.5,123,1.9,34,0.5,2456,38.6
E02006556,8821,100,4566,51.8,4424,50.2,142,1.6,167,1.9,130,1.5,37,0.4,4088,46.3
E02006557,6283,100,3846,61.2,3632,57.8,214,3.4,118,1.9,105,1.7,13,0.2,2319,36.9
E02006558,9369,100,5073,54.1,4821,51.5,252,2.7,216,2.3,158,1.7,58,0.6,4080,43.5
E02006559,7350,100,3029,41.2,2924,39.8,105,1.4,80,1.1,52,0.7,28,0.4,4241,57.7
E02006560,8452,100,4195,49.6,4043,47.8,152,1.8,125,1.5,92,1.1,33,0.4,4132,48.9
E02006561,5409,100,3200,59.2,3084,57,116,2.1,77,1.4,59,1.1,18,0.3,2132,39.4
E02006562,5108,100,2904,56.9,2812,55.1,92,1.8,71,1.4,53,1,18,0.4,2133,41.8
E02006563,4884,100,2733,56,2638,54,95,1.9,80,1.6,64,1.3,16,0.3,2071,42.4
E02006564,6743,100,3709,55,3592,53.3,117,1.7,82,1.2,65,1,17,0.3,2952,43.8
E02006565,6865,100,3737,54.4,3622,52.8,115,1.7,114,1.7,77,1.1,37,0.5,3014,43.9
E02006566,7009,100,3561,50.8,3452,49.3,109,1.6,130,1.9,89,1.3,41,0.6,3318,47.3
E02006567,6415,100,3683,57.4,3581,55.8,102,1.6,86,1.3,60,0.9,26,0.4,2646,41.2
E02006568,10376,100,5464,52.7,5231,50.4,233,2.2,542,5.2,377,3.6,165,1.6,4370,42.1
E02006569,8092,100,4606,56.9,4455,55.1,151,1.9,122,1.5,96,1.2,26,0.3,3364,41.6
E02006570,7874,100,4131,52.5,3958,50.3,173,2.2,315,4,217,2.8,98,1.2,3428,43.5
E02006571,7088,100,3911,55.2,3778,53.3,133,1.9,165,2.3,121,1.7,44,0.6,3012,42.5
E02006572,9364,100,5668,60.5,5424,57.9,244,2.6,255,2.7,184,2,71,0.8,3441,36.7
E02006573,9911,100,4988,50.3,4802,48.5,186,1.9,118,1.2,92,0.9,26,0.3,4805,48.5
E02006574,9581,100,4502,47,4277,44.6,225,2.3,134,1.4,107,1.1,27,0.3,4945,51.6
E02006575,6958,100,4325,62.2,3970,57.1,355,5.1,186,2.7,136,2,50,0.7,2447,35.2
E02006576,8331,100,5835,70,5564,66.8,271,3.3,138,1.7,107,1.3,31,0.4,2358,28.3
E02006577,7096,100,4462,62.9,4195,59.1,267,3.8,140,2,115,1.6,25,0.4,2494,35.1
E02006578,10025,100,6868,68.5,6364,63.5,504,5,180,1.8,147,1.5,33,0.3,2977,29.7
E02006579,6773,100,4449,65.7,4206,62.1,243,3.6,121,1.8,96,1.4,25,0.4,2203,32.5
E02006580,6751,100,4310,63.8,4023,59.6,287,4.3,147,2.2,105,1.6,42,0.6,2294,34
E02006581,8250,100,5392,65.4,4985,60.4,407,4.9,149,1.8,101,1.2,48,0.6,2709,32.8
E02006582,6246,100,4393,70.3,4176,66.9,217,3.5,131,2.1,80,1.3,51,0.8,1722,27.6
E02006583,7693,100,4893,63.6,4637,60.3,256,3.3,147,1.9,108,1.4,39,0.5,2653,34.5
E02006584,6064,100,4031,66.5,3724,61.4,307,5.1,113,1.9,75,1.2,38,0.6,1920,31.7
E02006585,6491,100,4122,63.5,3825,58.9,297,4.6,114,1.8,73,1.1,41,0.6,2255,34.7
E02006586,6164,100,4210,68.3,3861,62.6,349,5.7,175,2.8,128,2.1,47,0.8,1779,28.9
E02006587,6730,100,4389,65.2,4021,59.7,368,5.5,135,2,81,1.2,54,0.8,2206,32.8
E02006588,8468,100,5777,68.2,5527,65.3,250,3,108,1.3,90,1.1,18,0.2,2583,30.5
E02006589,9335,100,5874,62.9,5700,61.1,174,1.9,142,1.5,110,1.2,32,0.3,3319,35.6
E02006590,7214,100,4528,62.8,4360,60.4,168,2.3,111,1.5,89,1.2,22,0.3,2575,35.7
E02006591,6834,100,4360,63.8,4205,61.5,155,2.3,124,1.8,94,1.4,30,0.4,2350,34.4
E02006592,5483,100,3257,59.4,3159,57.6,98,1.8,73,1.3,61,1.1,12,0.2,2153,39.3
E02006593,9327,100,5778,61.9,5519,59.2,259,2.8,128,1.4,94,1,34,0.4,3421,36.7
E02006594,8558,100,5794,67.7,5595,65.4,199,2.3,135,1.6,101,1.2,34,0.4,2629,30.7
E02006595,7174,100,4056,56.5,3942,54.9,114,1.6,114,1.6,71,1,43,0.6,3004,41.9
E02006596,7533,100,5011,66.5,4873,64.7,138,1.8,170,2.3,129,1.7,41,0.5,2352,31.2
E02006597,9898,100,6460,65.3,6262,63.3,198,2,146,1.5,119,1.2,27,0.3,3292,33.3
E02006598,4628,100,2805,60.6,2709,58.5,96,2.1,79,1.7,58,1.3,21,0.5,1744,37.7
E02006599,6094,100,2841,46.6,2764,45.4,77,1.3,49,0.8,41,0.7,8,0.1,3204,52.6
E02006600,8386,100,4501,53.7,4338,51.7,163,1.9,70,0.8,49,0.6,21,0.3,3815,45.5
E02006601,7451,100,4152,55.7,3990,53.5,162,2.2,119,1.6,100,1.3,19,0.3,3180,42.7
E02006602,7086,100,4247,59.9,4104,57.9,143,2,88,1.2,67,0.9,21,0.3,2751,38.8
E02006603,7194,100,3874,53.9,3759,52.3,115,1.6,109,1.5,90,1.3,19,0.3,3211,44.6
E02006604,10903,100,7113,65.2,6855,62.9,258,2.4,180,1.7,141,1.3,39,0.4,3610,33.1
E02006605,5259,100,3277,62.3,3149,59.9,128,2.4,100,1.9,80,1.5,20,0.4,1882,35.8
E02006606,6731,100,4354,64.7,4221,62.7,133,2,81,1.2,66,1,15,0.2,2296,34.1
E02006607,6550,100,3958,60.4,3832,58.5,126,1.9,98,1.5,78,1.2,20,0.3,2494,38.1
E02006608,5191,100,3093,59.6,2990,57.6,103,2,90,1.7,67,1.3,23,0.4,2008,38.7
E02006609,5645,100,3332,59,3248,57.5,84,1.5,70,1.2,51,0.9,19,0.3,2243,39.7
E02006610,6339,100,4067,64.2,3944,62.2,123,1.9,74,1.2,63,1,11,0.2,2198,34.7
E02006611,9021,100,5253,58.2,5090,56.4,163,1.8,135,1.5,107,1.2,28,0.3,3633,40.3
E02006612,9661,100,6458,66.8,6222,64.4,236,2.4,142,1.5,113,1.2,29,0.3,3061,31.7
E02006613,6188,100,4049,65.4,3922,63.4,127,2.1,100,1.6,72,1.2,28,0.5,2039,33
E02006614,10123,100,6622,65.4,6418,63.4,204,2,157,1.6,125,1.2,32,0.3,3344,33
E02006615,5685,100,3920,69,3827,67.3,93,1.6,114,2,93,1.6,21,0.4,1651,29
E02006616,7939,100,5208,65.6,5035,63.4,173,2.2,116,1.5,95,1.2,21,0.3,2615,32.9
E02006617,7522,100,4715,62.7,4535,60.3,180,2.4,127,1.7,99,1.3,28,0.4,2680,35.6
E02006618,5385,100,3100,57.6,3012,55.9,88,1.6,93,1.7,72,1.3,21,0.4,2192,40.7
E02006619,7100,100,4388,61.8,4233,59.6,155,2.2,137,1.9,111,1.6,26,0.4,2575,36.3
E02006620,8091,100,4682,57.9,4526,55.9,156,1.9,113,1.4,91,1.1,22,0.3,3296,40.7
E02006621,6784,100,3389,50,3269,48.2,120,1.8,112,1.7,91,1.3,21,0.3,3283,48.4
E02006622,6547,100,3680,56.2,3545,54.1,135,2.1,113,1.7,82,1.3,31,0.5,2754,42.1
E02006623,6512,100,3701,56.8,3551,54.5,150,2.3,121,1.9,100,1.5,21,0.3,2690,41.3
E02006624,5991,100,3758,62.7,3616,60.4,142,2.4,133,2.2,94,1.6,39,0.7,2100,35.1
E02006625,6445,100,4415,68.5,4263,66.1,152,2.4,130,2,99,1.5,31,0.5,1900,29.5
E02006626,7694,100,5000,65,4793,62.3,207,2.7,173,2.2,128,1.7,45,0.6,2521,32.8
E02006627,7885,100,4839,61.4,4659,59.1,180,2.3,150,1.9,114,1.4,36,0.5,2896,36.7
E02006628,7158,100,4785,66.8,4545,63.5,240,3.4,159,2.2,114,1.6,45,0.6,2214,30.9
E02006629,6362,100,3796,59.7,3591,56.4,205,3.2,128,2,96,1.5,32,0.5,2438,38.3
E02006630,7804,100,4248,54.4,4042,51.8,206,2.6,79,1,63,0.8,16,0.2,3477,44.6
E02006631,8871,100,5632,63.5,5265,59.4,367,4.1,152,1.7,129,1.5,23,0.3,3087,34.8
E02006632,7054,100,3917,55.5,3786,53.7,131,1.9,102,1.4,86,1.2,16,0.2,3035,43
E02006633,7248,100,3455,47.7,3345,46.2,110,1.5,133,1.8,92,1.3,41,0.6,3660,50.5
E02002985,5482,100,3300,60.2,3187,58.1,113,2.1,104,1.9,77,1.4,27,0.5,2078,37.9
E02002986,5664,100,3560,62.9,3452,60.9,108,1.9,99,1.7,87,1.5,12,0.2,2005,35.4
E02002987,4811,100,2716,56.5,2650,55.1,66,1.4,99,2.1,85,1.8,14,0.3,1996,41.5
E02002988,4592,100,2722,59.3,2620,57.1,102,2.2,93,2,83,1.8,10,0.2,1777,38.7
E02002989,4474,100,2611,58.4,2540,56.8,71,1.6,72,1.6,55,1.2,17,0.4,1791,40
E02002990,4995,100,3183,63.7,3041,60.9,142,2.8,144,2.9,123,2.5,21,0.4,1668,33.4
E02002991,9741,100,5195,53.3,4951,50.8,244,2.5,417,4.3,322,3.3,95,1,4129,42.4
E02002992,4755,100,2693,56.6,2602,54.7,91,1.9,195,4.1,152,3.2,43,0.9,1867,39.3
E02002993,5482,100,2616,47.7,2474,45.1,142,2.6,464,8.5,315,5.7,149,2.7,2402,43.8
E02002994,8635,100,4871,56.4,4737,54.9,134,1.6,117,1.4,86,1,31,0.4,3647,42.2
E02002995,4694,100,2573,54.8,2413,51.4,160,3.4,216,4.6,162,3.5,54,1.2,1905,40.6
E02002996,10609,100,3489,32.9,3370,31.8,119,1.1,818,7.7,552,5.2,266,2.5,6302,59.4
E02002997,7570,100,2958,39.1,2833,37.4,125,1.7,756,10,514,6.8,242,3.2,3856,50.9
E02002998,5210,100,2114,40.6,2029,38.9,85,1.6,393,7.5,310,6,83,1.6,2703,51.9
E02002999,4669,100,2598,55.6,2485,53.2,113,2.4,173,3.7,142,3,31,0.7,1898,40.7
E02003000,8087,100,4443,54.9,4329,53.5,114,1.4,138,1.7,117,1.4,21,0.3,3506,43.4
E02003001,4553,100,2660,58.4,2585,56.8,75,1.6,110,2.4,76,1.7,34,0.7,1783,39.2
E02003002,4989,100,2727,54.7,2611,52.3,116,2.3,120,2.4,91,1.8,29,0.6,2142,42.9
E02003003,4905,100,2818,57.5,2701,55.1,117,2.4,163,3.3,131,2.7,32,0.7,1924,39.2
E02003004,6004,100,3872,64.5,3784,63,88,1.5,100,1.7,75,1.2,25,0.4,2032,33.8
E02003005,5513,100,3246,58.9,3161,57.3,85,1.5,101,1.8,76,1.4,25,0.5,2166,39.3
E02003006,8393,100,4527,53.9,4363,52,164,2,377,4.5,214,2.5,163,1.9,3489,41.6
E02003007,7741,100,4775,61.7,4639,59.9,136,1.8,120,1.6,95,1.2,25,0.3,2846,36.8
E02003008,4834,100,3093,64,2967,61.4,126,2.6,73,1.5,64,1.3,9,0.2,1668,34.5
E02003009,5101,100,3182,62.4,3089,60.6,93,1.8,68,1.3,44,0.9,24,0.5,1851,36.3
E02003010,5237,100,3389,64.7,3280,62.6,109,2.1,104,2,94,1.8,10,0.2,1744,33.3
E02003011,4876,100,2778,57,2688,55.1,90,1.8,106,2.2,84,1.7,22,0.5,1992,40.9
E02003012,9505,100,5816,61.2,5599,58.9,217,2.3,159,1.7,116,1.2,43,0.5,3530,37.1
E02003013,10041,100,6027,60,5693,56.7,334,3.3,275,2.7,196,2,79,0.8,3739,37.2
E02003014,6296,100,3747,59.5,3535,56.1,212,3.4,127,2,102,1.6,25,0.4,2422,38.5
E02003015,5612,100,3566,63.5,3411,60.8,155,2.8,186,3.3,143,2.5,43,0.8,1860,33.1
E02003016,6624,100,3796,57.3,3604,54.4,192,2.9,472,7.1,369,5.6,103,1.6,2356,35.6
E02003017,5112,100,2981,58.3,2897,56.7,84,1.6,66,1.3,57,1.1,9,0.2,2065,40.4
E02003018,4904,100,2935,59.8,2823,57.6,112,2.3,64,1.3,50,1,14,0.3,1905,38.8
E02003019,8315,100,5288,63.6,5068,61,220,2.6,117,1.4,100,1.2,17,0.2,2910,35
E02003020,5105,100,2777,54.4,2709,53.1,68,1.3,76,1.5,54,1.1,22,0.4,2252,44.1
E02003021,6205,100,3720,60,3612,58.2,108,1.7,465,7.5,341,5.5,124,2,2020,32.6
E02003022,4873,100,2829,58.1,2770,56.8,59,1.2,84,1.7,66,1.4,18,0.4,1960,40.2
E02003023,5653,100,2801,49.5,2693,47.6,108,1.9,320,5.7,213,3.8,107,1.9,2532,44.8
E02003024,8247,100,4646,56.3,4440,53.8,206,2.5,400,4.9,306,3.7,94,1.1,3201,38.8
E02003025,6156,100,3692,60,3532,57.4,160,2.6,246,4,191,3.1,55,0.9,2218,36
E02003026,8901,100,3582,40.2,3502,39.3,80,0.9,456,5.1,217,2.4,239,2.7,4863,54.6
E02003027,10812,100,7064,65.3,6832,63.2,232,2.1,654,6,494,4.6,160,1.5,3094,28.6
E02003028,7152,100,4558,63.7,4413,61.7,145,2,281,3.9,212,3,69,1,2313,32.3
E02003029,5182,100,3136,60.5,2963,57.2,173,3.3,131,2.5,83,1.6,48,0.9,1915,37
E02003030,6557,100,4208,64.2,4008,61.1,200,3.1,286,4.4,209,3.2,77,1.2,2063,31.5
E02003031,8921,100,5722,64.1,5520,61.9,202,2.3,516,5.8,385,4.3,131,1.5,2683,30.1
E02003032,6688,100,4308,64.4,4137,61.9,171,2.6,198,3,150,2.2,48,0.7,2182,32.6
E02003033,8117,100,4005,49.3,3859,47.5,146,1.8,797,9.8,587,7.2,210,2.6,3315,40.8
E02003036,7930,100,4328,54.6,4165,52.5,163,2.1,690,8.7,455,5.7,235,3,2912,36.7
E02003037,8482,100,4763,56.2,4620,54.5,143,1.7,727,8.6,559,6.6,168,2,2992,35.3
E02003038,5639,100,3782,67.1,3647,64.7,135,2.4,106,1.9,87,1.5,19,0.3,1751,31.1
E02003039,7233,100,4720,65.3,4511,62.4,209,2.9,159,2.2,132,1.8,27,0.4,2354,32.5
E02003040,8418,100,6279,74.6,6035,71.7,244,2.9,152,1.8,135,1.6,17,0.2,1987,23.6
E02003041,5598,100,3275,58.5,3184,56.9,91,1.6,308,5.5,220,3.9,88,1.6,2015,36
E02003044,5127,100,3474,67.8,3367,65.7,107,2.1,81,1.6,59,1.2,22,0.4,1572,30.7
E02003045,6381,100,3213,50.4,3078,48.2,135,2.1,579,9.1,385,6,194,3,2589,40.6
E02003046,8200,100,5910,72.1,5711,69.6,199,2.4,142,1.7,110,1.3,32,0.4,2148,26.2
E02003047,9351,100,6921,74,6707,71.7,214,2.3,246,2.6,186,2,60,0.6,2184,23.4
E02003048,5813,100,4457,76.7,4310,74.1,147,2.5,98,1.7,76,1.3,22,0.4,1258,21.6
E02003049,6393,100,4198,65.7,4029,63,169,2.6,95,1.5,80,1.3,15,0.2,2100,32.8
E02003050,9007,100,6556,72.8,6332,70.3,224,2.5,213,2.4,178,2,35,0.4,2238,24.8
E02003051,6018,100,4356,72.4,4182,69.5,174,2.9,137,2.3,92,1.5,45,0.7,1525,25.3
E02003052,5953,100,4197,70.5,4082,68.6,115,1.9,98,1.6,85,1.4,13,0.2,1658,27.9
E02003053,6979,100,4672,66.9,4497,64.4,175,2.5,130,1.9,103,1.5,27,0.4,2177,31.2
E02003054,5659,100,3727,65.9,3614,63.9,113,2,131,2.3,97,1.7,34,0.6,1801,31.8
E02003055,6918,100,4239,61.3,4000,57.8,239,3.5,166,2.4,135,2,31,0.4,2513,36.3
E02003056,5906,100,3387,57.3,3206,54.3,181,3.1,146,2.5,106,1.8,40,0.7,2373,40.2
E02003057,5053,100,3254,64.4,3186,63.1,68,1.3,69,1.4,51,1,18,0.4,1730,34.2
E02003058,7869,100,4802,61,4650,59.1,152,1.9,138,1.8,113,1.4,25,0.3,2929,37.2
E02003059,5377,100,3415,63.5,3297,61.3,118,2.2,86,1.6,61,1.1,25,0.5,1876,34.9
E02003060,9128,100,5364,58.8,5192,56.9,172,1.9,138,1.5,101,1.1,37,0.4,3626,39.7
E02003061,4764,100,2789,58.5,2635,55.3,154,3.2,92,1.9,64,1.3,28,0.6,1883,39.5
E02003062,4585,100,2621,57.2,2454,53.5,167,3.6,86,1.9,61,1.3,25,0.5,1878,41
E02003063,6020,100,3493,58,3431,57,62,1,81,1.3,54,0.9,27,0.4,2446,40.6
E02003064,5368,100,2904,54.1,2680,49.9,224,4.2,84,1.6,51,1,33,0.6,2380,44.3
E02006887,8801,100,5296,60.2,4983,56.6,313,3.6,544,6.2,323,3.7,221,2.5,2961,33.6
E02006888,5619,100,3466,61.7,3209,57.1,257,4.6,197,3.5,152,2.7,45,0.8,1956,34.8
E02006889,5769,100,3188,55.3,2888,50.1,300,5.2,230,4,160,2.8,70,1.2,2351,40.8
E02006890,7421,100,5047,68,4729,63.7,318,4.3,219,3,177,2.4,42,0.6,2155,29
E02006949,5684,100,3924,69,3702,65.1,222,3.9,185,3.3,140,2.5,45,0.8,1575,27.7
E02006950,6480,100,4186,64.6,3926,60.6,260,4,379,5.8,278,4.3,101,1.6,1915,29.6
E02006951,8142,100,2896,35.6,2781,34.2,115,1.4,1131,13.9,698,8.6,433,5.3,4115,50.5
E02006952,7628,100,3088,40.5,2955,38.7,133,1.7,807,10.6,493,6.5,314,4.1,3733,48.9
E02003065,8132,100,4902,60.3,4749,58.4,153,1.9,148,1.8,111,1.4,37,0.5,3082,37.9
E02003066,5161,100,2775,53.8,2698,52.3,77,1.5,85,1.6,66,1.3,19,0.4,2301,44.6
E02003067,6420,100,3961,61.7,3876,60.4,85,1.3,133,2.1,103,1.6,30,0.5,2326,36.2
E02003068,5298,100,3111,58.7,3034,57.3,77,1.5,89,1.7,71,1.3,18,0.3,2098,39.6
E02003069,4833,100,2544,52.6,2482,51.4,62,1.3,66,1.4,57,1.2,9,0.2,2223,46
E02003070,10577,100,6440,60.9,6282,59.4,158,1.5,165,1.6,121,1.1,44,0.4,3972,37.6
E02003071,6702,100,3804,56.8,3687,55,117,1.7,105,1.6,89,1.3,16,0.2,2793,41.7
E02003072,7851,100,4172,53.1,4070,51.8,102,1.3,121,1.5,95,1.2,26,0.3,3558,45.3
E02003073,5270,100,2875,54.6,2817,53.5,58,1.1,101,1.9,86,1.6,15,0.3,2294,43.5
E02003074,6389,100,3937,61.6,3826,59.9,111,1.7,101,1.6,81,1.3,20,0.3,2351,36.8
E02003075,4912,100,2895,58.9,2817,57.3,78,1.6,91,1.9,61,1.2,30,0.6,1926,39.2
E02003076,8090,100,4832,59.7,4714,58.3,118,1.5,132,1.6,116,1.4,16,0.2,3126,38.6
E02003077,5255,100,3139,59.7,3057,58.2,82,1.6,89,1.7,72,1.4,17,0.3,2027,38.6
E02003078,6146,100,3372,54.9,3273,53.3,99,1.6,125,2,109,1.8,16,0.3,2649,43.1
E02003079,7512,100,4816,64.1,4674,62.2,142,1.9,151,2,122,1.6,29,0.4,2545,33.9
E02003080,7307,100,3743,51.2,3603,49.3,140,1.9,111,1.5,91,1.2,20,0.3,3453,47.3
E02003081,7981,100,4354,54.6,4213,52.8,141,1.8,175,2.2,139,1.7,36,0.5,3452,43.3
E02003082,8144,100,4508,55.4,4272,52.5,236,2.9,131,1.6,109,1.3,22,0.3,3505,43
E02003084,9015,100,5111,56.7,4802,53.3,309,3.4,156,1.7,131,1.5,25,0.3,3748,41.6
E02003085,6074,100,3359,55.3,3137,51.6,222,3.7,118,1.9,91,1.5,27,0.4,2597,42.8
E02003086,5339,100,2786,52.2,2678,50.2,108,2,103,1.9,86,1.6,17,0.3,2450,45.9
E02003087,9005,100,5004,55.6,4861,54,143,1.6,152,1.7,124,1.4,28,0.3,3849,42.7
E02003088,7529,100,3904,51.9,3816,50.7,88,1.2,134,1.8,108,1.4,26,0.3,3491,46.4
E02003089,4919,100,2571,52.3,2466,50.1,105,2.1,98,2,76,1.5,22,0.4,2250,45.7
E02006845,7486,100,5017,67,4881,65.2,136,1.8,173,2.3,135,1.8,38,0.5,2296,30.7
E02006846,7216,100,5472,75.8,5317,73.7,155,2.1,182,2.5,152,2.1,30,0.4,1562,21.6
E02003090,7583,100,4429,58.4,4313,56.9,116,1.5,118,1.6,90,1.2,28,0.4,3036,40
E02003091,5575,100,3211,57.6,3118,55.9,93,1.7,80,1.4,64,1.1,16,0.3,2284,41
E02003092,7255,100,4542,62.6,4431,61.1,111,1.5,145,2,112,1.5,33,0.5,2568,35.4
E02003093,5684,100,3056,53.8,2969,52.2,87,1.5,82,1.4,68,1.2,14,0.2,2546,44.8
E02003094,7280,100,4539,62.3,4414,60.6,125,1.7,139,1.9,101,1.4,38,0.5,2602,35.7
E02003095,7040,100,4579,65,4469,63.5,110,1.6,155,2.2,126,1.8,29,0.4,2306,32.8
E02003096,5209,100,3302,63.4,3195,61.3,107,2.1,93,1.8,74,1.4,19,0.4,1814,34.8
E02003097,5504,100,3028,55,2949,53.6,79,1.4,86,1.6,61,1.1,25,0.5,2390,43.4
E02003098,8012,100,6044,75.4,5861,73.2,183,2.3,196,2.4,166,2.1,30,0.4,1772,22.1
E02003099,6194,100,3753,60.6,3666,59.2,87,1.4,102,1.6,78,1.3,24,0.4,2339,37.8
E02003101,8521,100,6181,72.5,6028,70.7,153,1.8,203,2.4,169,2,34,0.4,2137,25.1
E02003102,5741,100,3406,59.3,3331,58,75,1.3,91,1.6,71,1.2,20,0.3,2244,39.1
E02003103,5663,100,3911,69.1,3818,67.4,93,1.6,106,1.9,84,1.5,22,0.4,1646,29.1
E02003104,6189,100,3957,63.9,3825,61.8,132,2.1,127,2.1,102,1.6,25,0.4,2105,34
E02003105,5283,100,3017,57.1,2927,55.4,90,1.7,75,1.4,52,1,23,0.4,2191,41.5
E02003107,9641,100,5419,56.2,5187,53.8,232,2.4,630,6.5,462,4.8,168,1.7,3592,37.3
E02003108,10283,100,6568,63.9,6391,62.2,177,1.7,180,1.8,128,1.2,52,0.5,3535,34.4
E02003109,4998,100,3021,60.4,2969,59.4,52,1,102,2,84,1.7,18,0.4,1875,37.5
E02003110,9607,100,6736,70.1,6564,68.3,172,1.8,248,2.6,196,2,52,0.5,2623,27.3
E02003111,5525,100,3318,60.1,3238,58.6,80,1.4,113,2,87,1.6,26,0.5,2094,37.9
E02003112,5199,100,3155,60.7,3041,58.5,114,2.2,107,2.1,85,1.6,22,0.4,1937,37.3
E02003113,8705,100,5294,60.8,5155,59.2,139,1.6,125,1.4,96,1.1,29,0.3,3286,37.7
E02003114,5988,100,3630,60.6,3499,58.4,131,2.2,100,1.7,80,1.3,20,0.3,2258,37.7
E02003115,7960,100,5098,64,4898,61.5,200,2.5,168,2.1,133,1.7,35,0.4,2694,33.8
E02003116,6350,100,3884,61.2,3699,58.3,185,2.9,104,1.6,70,1.1,34,0.5,2362,37.2
E02003117,7634,100,4968,65.1,4787,62.7,181,2.4,104,1.4,77,1,27,0.4,2562,33.6
E02003118,8241,100,5552,67.4,5419,65.8,133,1.6,145,1.8,106,1.3,39,0.5,2544,30.9
E02003119,8368,100,5333,63.7,5169,61.8,164,2,141,1.7,100,1.2,41,0.5,2894,34.6
E02003120,7610,100,4557,59.9,4436,58.3,121,1.6,117,1.5,84,1.1,33,0.4,2936,38.6
E02003121,8571,100,5074,59.2,4951,57.8,123,1.4,139,1.6,103,1.2,36,0.4,3358,39.2
E02007064,6440,100,4036,62.7,3894,60.5,142,2.2,105,1.6,92,1.4,13,0.2,2299,35.7
E02007065,5991,100,4385,73.2,4249,70.9,136,2.3,151,2.5,120,2,31,0.5,1455,24.3
E02007066,7944,100,3173,39.9,3068,38.6,105,1.3,1024,12.9,570,7.2,454,5.7,3747,47.2
E02007067,5560,100,3532,63.5,3447,62,85,1.5,156,2.8,125,2.2,31,0.6,1872,33.7
E02003122,6120,100,3144,51.4,3068,50.1,76,1.2,98,1.6,80,1.3,18,0.3,2878,47
E02003123,6875,100,3851,56,3684,53.6,167,2.4,123,1.8,95,1.4,28,0.4,2901,42.2
E02003124,6451,100,3807,59,3626,56.2,181,2.8,97,1.5,82,1.3,15,0.2,2547,39.5
E02003125,4976,100,2647,53.2,2501,50.3,146,2.9,79,1.6,63,1.3,16,0.3,2250,45.2
E02003126,6995,100,3739,53.5,3628,51.9,111,1.6,259,3.7,202,2.9,57,0.8,2997,42.8
E02003127,5988,100,3366,56.2,3190,53.3,176,2.9,113,1.9,78,1.3,35,0.6,2509,41.9
E02003128,7368,100,4194,56.9,4027,54.7,167,2.3,123,1.7,92,1.2,31,0.4,3051,41.4
E02003129,5223,100,3002,57.5,2904,55.6,98,1.9,91,1.7,63,1.2,28,0.5,2130,40.8
E02003130,8446,100,4625,54.8,4402,52.1,223,2.6,136,1.6,102,1.2,34,0.4,3685,43.6
E02003131,5963,100,3403,57.1,3293,55.2,110,1.8,126,2.1,96,1.6,30,0.5,2434,40.8
E02003132,7044,100,4229,60,4067,57.7,162,2.3,98,1.4,78,1.1,20,0.3,2717,38.6
E02003133,5876,100,3324,56.6,3234,55,90,1.5,111,1.9,83,1.4,28,0.5,2441,41.5
E02003134,5496,100,3157,57.4,3010,54.8,147,2.7,113,2.1,81,1.5,32,0.6,2226,40.5
E02003135,5527,100,3299,59.7,3144,56.9,155,2.8,109,2,89,1.6,20,0.4,2119,38.3
E02003136,6594,100,3443,52.2,3344,50.7,99,1.5,141,2.1,110,1.7,31,0.5,3010,45.6
E02003137,6522,100,3735,57.3,3653,56,82,1.3,122,1.9,93,1.4,29,0.4,2665,40.9
E02003138,6112,100,4081,66.8,3934,64.4,147,2.4,186,3,155,2.5,31,0.5,1845,30.2
E02003139,5343,100,3622,67.8,3527,66,95,1.8,105,2,89,1.7,16,0.3,1616,30.2
E02003140,6355,100,3771,59.3,3693,58.1,78,1.2,139,2.2,109,1.7,30,0.5,2445,38.5
E02003141,6666,100,4142,62.1,3894,58.4,248,3.7,124,1.9,101,1.5,23,0.3,2400,36
E02003142,7416,100,4211,56.8,4019,54.2,192,2.6,121,1.6,97,1.3,24,0.3,3084,41.6
E02003143,5996,100,3490,58.2,3403,56.8,87,1.5,112,1.9,83,1.4,29,0.5,2394,39.9
E02003144,7848,100,3304,42.1,3089,39.4,215,2.7,968,12.3,681,8.7,287,3.7,3576,45.6
E02003145,5674,100,3211,56.6,3042,53.6,169,3,196,3.5,144,2.5,52,0.9,2267,40
E02003146,7299,100,4226,57.9,3988,54.6,238,3.3,467,6.4,350,4.8,117,1.6,2606,35.7
E02003147,7182,100,4120,57.4,3779,52.6,341,4.7,126,1.8,93,1.3,33,0.5,2936,40.9
E02003148,10416,100,3688,35.4,3393,32.6,295,2.8,1207,11.6,742,7.1,465,4.5,5521,53
E02003149,7931,100,4340,54.7,4060,51.2,280,3.5,404,5.1,305,3.8,99,1.2,3187,40.2
E02003151,6980,100,3455,49.5,3371,48.3,84,1.2,112,1.6,81,1.2,31,0.4,3413,48.9
E02003152,9273,100,5506,59.4,5345,57.6,161,1.7,187,2,151,1.6,36,0.4,3580,38.6
E02003153,6131,100,3466,56.5,3374,55,92,1.5,112,1.8,93,1.5,19,0.3,2553,41.6
E02006989,4559,100,2424,53.2,2266,49.7,158,3.5,200,4.4,164,3.6,36,0.8,1935,42.4
E02006990,5958,100,3244,54.4,3014,50.6,230,3.9,159,2.7,115,1.9,44,0.7,2555,42.9
E02003154,5813,100,2975,51.2,2817,48.5,158,2.7,83,1.4,56,1,27,0.5,2755,47.4
E02003155,5019,100,2472,49.3,2357,47,115,2.3,62,1.2,51,1,11,0.2,2485,49.5
E02003156,8500,100,5116,60.2,4939,58.1,177,2.1,191,2.2,152,1.8,39,0.5,3193,37.6
E02003157,5523,100,3090,55.9,2898,52.5,192,3.5,87,1.6,72,1.3,15,0.3,2346,42.5
E02003158,4850,100,2434,50.2,2300,47.4,134,2.8,82,1.7,60,1.2,22,0.5,2334,48.1
E02003159,4801,100,2959,61.6,2788,58.1,171,3.6,67,1.4,55,1.1,12,0.2,1775,37
E02003161,6643,100,3596,54.1,3289,49.5,307,4.6,64,1,50,0.8,14,0.2,2983,44.9
E02003163,7533,100,3250,43.1,3091,41,159,2.1,60,0.8,35,0.5,25,0.3,4223,56.1
E02003164,7685,100,3984,51.8,3835,49.9,149,1.9,112,1.5,83,1.1,29,0.4,3589,46.7
E02003165,6034,100,3389,56.2,3263,54.1,126,2.1,106,1.8,80,1.3,26,0.4,2539,42.1
E02003166,10137,100,5759,56.8,5477,54,282,2.8,159,1.6,114,1.1,45,0.4,4219,41.6
E02003167,8669,100,4159,48,3896,44.9,263,3,95,1.1,74,0.9,21,0.2,4415,50.9
E02003168,6142,100,3090,50.3,2966,48.3,124,2,89,1.4,71,1.2,18,0.3,2963,48.2
E02003169,5867,100,2498,42.6,2410,41.1,88,1.5,104,1.8,86,1.5,18,0.3,3265,55.7
E02003170,8332,100,3713,44.6,3506,42.1,207,2.5,104,1.2,81,1,23,0.3,4515,54.2
E02003171,6285,100,3017,48,2864,45.6,153,2.4,76,1.2,46,0.7,30,0.5,3192,50.8
E02006840,9204,100,5183,56.3,4965,53.9,218,2.4,157,1.7,107,1.2,50,0.5,3864,42
E02003212,7060,100,4041,57.2,3892,55.1,149,2.1,122,1.7,84,1.2,38,0.5,2897,41
E02003214,4996,100,2785,55.7,2547,51,238,4.8,77,1.5,44,0.9,33,0.7,2134,42.7
E02003215,5793,100,3281,56.6,3174,54.8,107,1.8,70,1.2,51,0.9,19,0.3,2442,42.2
E02003216,8257,100,5004,60.6,4798,58.1,206,2.5,111,1.3,79,1,32,0.4,3142,38.1
E02003217,5788,100,3477,60.1,3316,57.3,161,2.8,71,1.2,62,1.1,9,0.2,2240,38.7
E02003218,5178,100,2954,57,2768,53.5,186,3.6,87,1.7,60,1.2,27,0.5,2137,41.3
E02003219,9972,100,6964,69.8,6812,68.3,152,1.5,163,1.6,124,1.2,39,0.4,2845,28.5
E02003220,8667,100,5283,61,5077,58.6,206,2.4,171,2,126,1.5,45,0.5,3213,37.1
E02003221,5888,100,3845,65.3,3649,62,196,3.3,117,2,74,1.3,43,0.7,1926,32.7
E02003222,4854,100,3404,70.1,3273,67.4,131,2.7,70,1.4,49,1,21,0.4,1380,28.4
E02003223,8790,100,6235,70.9,5974,68,261,3,141,1.6,109,1.2,32,0.4,2414,27.5
E02003224,7235,100,4294,59.4,4185,57.8,109,1.5,95,1.3,66,0.9,29,0.4,2846,39.3
E02003225,5273,100,3517,66.7,3393,64.3,124,2.4,67,1.3,46,0.9,21,0.4,1689,32
E02003226,8555,100,6015,70.3,5645,66,370,4.3,201,2.3,151,1.8,50,0.6,2339,27.3
E02003227,5294,100,2964,56,2720,51.4,244,4.6,126,2.4,92,1.7,34,0.6,2204,41.6
E02003228,6218,100,4059,65.3,3890,62.6,169,2.7,117,1.9,100,1.6,17,0.3,2042,32.8
E02003229,4597,100,3083,67.1,2992,65.1,91,2,90,2,79,1.7,11,0.2,1424,31
E02003230,7290,100,5242,71.9,4969,68.2,273,3.7,107,1.5,87,1.2,20,0.3,1941,26.6
E02003231,6571,100,3743,57,3474,52.9,269,4.1,97,1.5,65,1,32,0.5,2731,41.6
E02003232,7009,100,4847,69.2,4654,66.4,193,2.8,123,1.8,84,1.2,39,0.6,2039,29.1
E02003233,6994,100,4055,58,3819,54.6,236,3.4,97,1.4,74,1.1,23,0.3,2842,40.6
E02003234,7016,100,4046,57.7,3889,55.4,157,2.2,119,1.7,72,1,47,0.7,2851,40.6
E02003235,7657,100,4799,62.7,4643,60.6,156,2,127,1.7,96,1.3,31,0.4,2731,35.7
E02003236,10446,100,6264,60,6047,57.9,217,2.1,164,1.6,102,1,62,0.6,4018,38.5
E02006847,7379,100,5614,76.1,5459,74,155,2.1,213,2.9,136,1.8,77,1,1552,21
E02006848,6327,100,4973,78.6,4788,75.7,185,2.9,159,2.5,110,1.7,49,0.8,1195,18.9
E02006849,8047,100,5851,72.7,5675,70.5,176,2.2,163,2,119,1.5,44,0.5,2033,25.3
E02003892,5751,100,2973,51.7,2866,49.8,107,1.9,51,0.9,42,0.7,9,0.2,2727,47.4
E02003893,5696,100,3026,53.1,2927,51.4,99,1.7,53,0.9,44,0.8,9,0.2,2617,45.9
E02003894,7007,100,3804,54.3,3659,52.2,145,2.1,65,0.9,50,0.7,15,0.2,3138,44.8
E02003895,7737,100,4393,56.8,4237,54.8,156,2,104,1.3,88,1.1,16,0.2,3240,41.9
E02003896,4974,100,2537,51,2394,48.1,143,2.9,64,1.3,48,1,16,0.3,2373,47.7
E02003897,4533,100,2570,56.7,2532,55.9,38,0.8,70,1.5,58,1.3,12,0.3,1893,41.8
E02003898,5815,100,3028,52.1,2933,50.4,95,1.6,86,1.5,70,1.2,16,0.3,2701,46.4
E02003899,4393,100,2221,50.6,2128,48.4,93,2.1,43,1,36,0.8,7,0.2,2129,48.5
E02003900,5858,100,3254,55.5,3155,53.9,99,1.7,98,1.7,74,1.3,24,0.4,2506,42.8
E02003901,7165,100,3468,48.4,3328,46.4,140,2,83,1.2,62,0.9,21,0.3,3614,50.4
E02003902,4412,100,2439,55.3,2345,53.2,94,2.1,58,1.3,42,1,16,0.4,1915,43.4
E02003903,5307,100,2746,51.7,2644,49.8,102,1.9,67,1.3,53,1,14,0.3,2494,47
E02003904,4489,100,2161,48.1,2059,45.9,102,2.3,62,1.4,50,1.1,12,0.3,2266,50.5
E02003905,5828,100,3509,60.2,3409,58.5,100,1.7,97,1.7,85,1.5,12,0.2,2222,38.1
E02003906,5295,100,2940,55.5,2836,53.6,104,2,75,1.4,64,1.2,11,0.2,2280,43.1
E02003907,6919,100,3980,57.5,3854,55.7,126,1.8,104,1.5,91,1.3,13,0.2,2835,41
E02003908,6964,100,3868,55.5,3715,53.3,153,2.2,142,2,88,1.3,54,0.8,2954,42.4
E02003909,8954,100,5095,56.9,4911,54.8,184,2.1,197,2.2,147,1.6,50,0.6,3662,40.9
E02003910,5852,100,3393,58,3256,55.6,137,2.3,105,1.8,82,1.4,23,0.4,2354,40.2
E02003911,7690,100,4042,52.6,3963,51.5,79,1,131,1.7,87,1.1,44,0.6,3517,45.7
E02003912,7033,100,3821,54.3,3735,53.1,86,1.2,104,1.5,80,1.1,24,0.3,3108,44.2
E02003913,5111,100,2439,47.7,2372,46.4,67,1.3,62,1.2,46,0.9,16,0.3,2610,51.1
E02003914,7228,100,3729,51.6,3530,48.8,199,2.8,412,5.7,279,3.9,133,1.8,3087,42.7
E02003915,7218,100,3229,44.7,3026,41.9,203,2.8,529,7.3,361,5,168,2.3,3460,47.9
E02003916,6481,100,2597,40.1,2461,38,136,2.1,652,10.1,426,6.6,226,3.5,3232,49.9
E02003917,6865,100,4006,58.4,3863,56.3,143,2.1,163,2.4,126,1.8,37,0.5,2696,39.3
E02003918,6047,100,3309,54.7,3199,52.9,110,1.8,103,1.7,86,1.4,17,0.3,2635,43.6
E02003919,6023,100,3490,57.9,3329,55.3,161,2.7,89,1.5,61,1,28,0.5,2444,40.6
E02003920,6750,100,4085,60.5,3949,58.5,136,2,104,1.5,88,1.3,16,0.2,2561,37.9
E02003921,5262,100,2976,56.6,2890,54.9,86,1.6,64,1.2,50,1,14,0.3,2222,42.2
E02003922,7274,100,4264,58.6,4071,56,193,2.7,113,1.6,96,1.3,17,0.2,2897,39.8
E02003923,7529,100,4464,59.3,4261,56.6,203,2.7,97,1.3,82,1.1,15,0.2,2968,39.4
E02003924,6215,100,3068,49.4,2944,47.4,124,2,97,1.6,74,1.2,23,0.4,3050,49.1
E02003925,5890,100,3170,53.8,3029,51.4,141,2.4,75,1.3,59,1,16,0.3,2645,44.9
E02003926,6961,100,4151,59.6,4034,58,117,1.7,83,1.2,65,0.9,18,0.3,2727,39.2
E02003927,9196,100,4179,45.4,4045,44,134,1.5,332,3.6,196,2.1,136,1.5,4685,50.9
E02003928,9687,100,5815,60,5598,57.8,217,2.2,204,2.1,160,1.7,44,0.5,3668,37.9
E02003929,5916,100,3009,50.9,2903,49.1,106,1.8,87,1.5,76,1.3,11,0.2,2820,47.7
E02003930,7582,100,3811,50.3,3662,48.3,149,2,106,1.4,76,1,30,0.4,3665,48.3
E02003931,8790,100,4418,50.3,4183,47.6,235,2.7,93,1.1,69,0.8,24,0.3,4279,48.7
E02003932,6207,100,3345,53.9,3242,52.2,103,1.7,60,1,50,0.8,10,0.2,2802,45.1
E02003933,6008,100,3189,53.1,3057,50.9,132,2.2,57,0.9,45,0.7,12,0.2,2762,46
E02003934,5957,100,3223,54.1,3063,51.4,160,2.7,72,1.2,53,0.9,19,0.3,2662,44.7
E02003935,8241,100,4718,57.3,4545,55.2,173,2.1,113,1.4,95,1.2,18,0.2,3410,41.4
E02003936,7234,100,3791,52.4,3683,50.9,108,1.5,81,1.1,57,0.8,24,0.3,3362,46.5
E02003937,4475,100,2394,53.5,2323,51.9,71,1.6,72,1.6,58,1.3,14,0.3,2009,44.9
E02003938,5581,100,3157,56.6,3052,54.7,105,1.9,64,1.1,48,0.9,16,0.3,2360,42.3
E02003939,5748,100,3063,53.3,2954,51.4,109,1.9,101,1.8,75,1.3,26,0.5,2584,45
E02003940,5508,100,3002,54.5,2903,52.7,99,1.8,56,1,39,0.7,17,0.3,2450,44.5
E02003941,7283,100,4220,57.9,4061,55.8,159,2.2,79,1.1,62,0.9,17,0.2,2984,41
E02003942,6360,100,3614,56.8,3410,53.6,204,3.2,104,1.6,86,1.4,18,0.3,2642,41.5
E02003943,5911,100,3022,51.1,2875,48.6,147,2.5,53,0.9,43,0.7,10,0.2,2836,48
E02003944,8541,100,4627,54.2,4392,51.4,235,2.8,123,1.4,96,1.1,27,0.3,3791,44.4
E02003945,5164,100,2546,49.3,2446,47.4,100,1.9,71,1.4,48,0.9,23,0.4,2547,49.3
E02003946,7870,100,4260,54.1,4106,52.2,154,2,116,1.5,86,1.1,30,0.4,3494,44.4
E02003947,5607,100,2929,52.2,2842,50.7,87,1.6,68,1.2,57,1,11,0.2,2610,46.5
E02003948,6972,100,3436,49.3,3232,46.4,204,2.9,109,1.6,88,1.3,21,0.3,3427,49.2
E02003949,5703,100,2915,51.1,2692,47.2,223,3.9,71,1.2,43,0.8,28,0.5,2717,47.6
E02003950,4610,100,2396,52,2313,50.2,83,1.8,46,1,32,0.7,14,0.3,2168,47
E02003951,5020,100,2442,48.6,2328,46.4,114,2.3,76,1.5,61,1.2,15,0.3,2502,49.8
E02003952,7844,100,4872,62.1,4680,59.7,192,2.4,106,1.4,79,1,27,0.3,2866,36.5
E02003953,8809,100,5186,58.9,4982,56.6,204,2.3,131,1.5,110,1.2,21,0.2,3492,39.6
E02003954,6628,100,3874,58.4,3649,55.1,225,3.4,108,1.6,90,1.4,18,0.3,2646,39.9
E02003955,8414,100,4890,58.1,4646,55.2,244,2.9,112,1.3,84,1,28,0.3,3412,40.6
E02003956,6336,100,3738,59,3587,56.6,151,2.4,86,1.4,72,1.1,14,0.2,2512,39.6
E02003957,9130,100,5055,55.4,4848,53.1,207,2.3,146,1.6,107,1.2,39,0.4,3929,43
E02003958,6708,100,3846,57.3,3695,55.1,151,2.3,98,1.5,55,0.8,43,0.6,2764,41.2
E02003959,5648,100,3213,56.9,3076,54.5,137,2.4,97,1.7,78,1.4,19,0.3,2338,41.4
E02003960,4980,100,2431,48.8,2343,47,88,1.8,56,1.1,44,0.9,12,0.2,2493,50.1
E02003961,8006,100,4390,54.8,4244,53,146,1.8,127,1.6,104,1.3,23,0.3,3489,43.6
E02003962,5974,100,3347,56,3171,53.1,176,2.9,84,1.4,66,1.1,18,0.3,2543,42.6
E02003963,8274,100,4250,51.4,4029,48.7,221,2.7,132,1.6,96,1.2,36,0.4,3892,47
E02003964,6972,100,3480,49.9,3350,48,130,1.9,73,1,56,0.8,17,0.2,3419,49
E02006781,1729,100,1116,64.5,1102,63.7,14,0.8,12,0.7,11,0.6,1,0.1,601,34.8
E02006634,7141,100,4251,59.5,4126,57.8,125,1.8,115,1.6,99,1.4,16,0.2,2775,38.9
E02006635,7430,100,3860,52,3734,50.3,126,1.7,114,1.5,85,1.1,29,0.4,3456,46.5
E02006636,6000,100,3513,58.6,3385,56.4,128,2.1,57,0.9,46,0.8,11,0.2,2430,40.5
E02006637,9002,100,5550,61.7,5363,59.6,187,2.1,130,1.4,95,1.1,35,0.4,3322,36.9
E02006638,5503,100,2851,51.8,2714,49.3,137,2.5,67,1.2,53,1,14,0.3,2585,47
E02006639,7334,100,3988,54.4,3857,52.6,131,1.8,96,1.3,61,0.8,35,0.5,3250,44.3
E02006640,6086,100,3694,60.7,3581,58.8,113,1.9,79,1.3,64,1.1,15,0.2,2313,38
E02006641,6765,100,3993,59,3894,57.6,99,1.5,82,1.2,68,1,14,0.2,2690,39.8
E02006642,4792,100,2905,60.6,2821,58.9,84,1.8,69,1.4,46,1,23,0.5,1818,37.9
E02006644,5709,100,3297,57.8,3188,55.8,109,1.9,57,1,39,0.7,18,0.3,2355,41.3
E02006645,6384,100,3948,61.8,3815,59.8,133,2.1,151,2.4,129,2,22,0.3,2285,35.8
E02006646,6547,100,4222,64.5,4119,62.9,103,1.6,102,1.6,86,1.3,16,0.2,2223,34
E02006647,5128,100,3024,59,2939,57.3,85,1.7,62,1.2,46,0.9,16,0.3,2042,39.8
E02006648,5145,100,3056,59.4,2972,57.8,84,1.6,72,1.4,48,0.9,24,0.5,2017,39.2
E02006649,6329,100,3875,61.2,3738,59.1,137,2.2,78,1.2,46,0.7,32,0.5,2376,37.5
E02006650,11804,100,7477,63.3,7313,62,164,1.4,227,1.9,209,1.8,18,0.2,4100,34.7
E02006651,6072,100,3701,61,3599,59.3,102,1.7,105,1.7,87,1.4,18,0.3,2266,37.3
E02006652,7935,100,5186,65.4,5010,63.1,176,2.2,172,2.2,137,1.7,35,0.4,2577,32.5
E02006653,8088,100,5195,64.2,5023,62.1,172,2.1,168,2.1,130,1.6,38,0.5,2725,33.7
E02006654,8066,100,4774,59.2,4539,56.3,235,2.9,131,1.6,101,1.3,30,0.4,3161,39.2
E02006655,6892,100,4181,60.7,4058,58.9,123,1.8,110,1.6,75,1.1,35,0.5,2601,37.7
E02006656,5577,100,3833,68.7,3699,66.3,134,2.4,111,2,78,1.4,33,0.6,1633,29.3
E02006657,8724,100,5535,63.4,5317,60.9,218,2.5,154,1.8,107,1.2,47,0.5,3035,34.8
E02006658,6645,100,4075,61.3,3907,58.8,168,2.5,63,0.9,54,0.8,9,0.1,2507,37.7
E02006659,6664,100,4239,63.6,4121,61.8,118,1.8,68,1,52,0.8,16,0.2,2357,35.4
E02006660,11055,100,6610,59.8,6389,57.8,221,2,140,1.3,113,1,27,0.2,4305,38.9
E02006661,7582,100,5551,73.2,5435,71.7,116,1.5,140,1.8,110,1.5,30,0.4,1891,24.9
E02006662,5721,100,3789,66.2,3690,64.5,99,1.7,88,1.5,72,1.3,16,0.3,1844,32.2
E02006663,10439,100,6921,66.3,6749,64.7,172,1.6,200,1.9,149,1.4,51,0.5,3318,31.8
E02006664,5371,100,3152,58.7,3047,56.7,105,2,72,1.3,58,1.1,14,0.3,2147,40
E02006665,5812,100,3026,52.1,2904,50,122,2.1,68,1.2,55,0.9,13,0.2,2718,46.8
E02006666,5421,100,3386,62.5,3280,60.5,106,2,81,1.5,65,1.2,16,0.3,1954,36
E02006667,5758,100,3827,66.5,3651,63.4,176,3.1,105,1.8,84,1.5,21,0.4,1826,31.7
E02006668,4978,100,2855,57.4,2753,55.3,102,2,87,1.7,67,1.3,20,0.4,2036,40.9
E02006669,8789,100,5092,57.9,4962,56.5,130,1.5,109,1.2,84,1,25,0.3,3588,40.8
E02006670,5835,100,3844,65.9,3727,63.9,117,2,74,1.3,52,0.9,22,0.4,1917,32.9
E02006671,5308,100,3260,61.4,3130,59,130,2.4,83,1.6,69,1.3,14,0.3,1965,37
E02006672,7505,100,4805,64,4679,62.3,126,1.7,110,1.5,79,1.1,31,0.4,2590,34.5
E02006673,4404,100,2330,52.9,2239,50.8,91,2.1,86,2,75,1.7,11,0.2,1988,45.1
E02006674,4907,100,2932,59.8,2808,57.2,124,2.5,77,1.6,65,1.3,12,0.2,1898,38.7
E02006675,6805,100,3891,57.2,3770,55.4,121,1.8,107,1.6,86,1.3,21,0.3,2807,41.2
E02006676,5223,100,2927,56,2841,54.4,86,1.6,50,1,40,0.8,10,0.2,2246,43
E02006677,6683,100,3702,55.4,3611,54,91,1.4,96,1.4,84,1.3,12,0.2,2885,43.2
E02006678,6331,100,3859,61,3723,58.8,136,2.1,88,1.4,73,1.2,15,0.2,2384,37.7
E02006679,10041,100,6214,61.9,6019,59.9,195,1.9,143,1.4,109,1.1,34,0.3,3684,36.7
E02006680,6379,100,3707,58.1,3577,56.1,130,2,100,1.6,80,1.3,20,0.3,2572,40.3
E02006681,4955,100,2718,54.9,2625,53,93,1.9,60,1.2,43,0.9,17,0.3,2177,43.9
E02006682,8680,100,4693,54.1,4511,52,182,2.1,104,1.2,85,1,19,0.2,3883,44.7
E02006683,6559,100,4079,62.2,3967,60.5,112,1.7,126,1.9,99,1.5,27,0.4,2354,35.9
E02006684,5741,100,3627,63.2,3457,60.2,170,3,96,1.7,76,1.3,20,0.3,2018,35.2
E02006685,8031,100,5071,63.1,4903,61.1,168,2.1,132,1.6,104,1.3,28,0.3,2828,35.2
E02006686,4496,100,2590,57.6,2484,55.2,106,2.4,79,1.8,54,1.2,25,0.6,1827,40.6
E02006687,6537,100,4182,64,4007,61.3,175,2.7,112,1.7,83,1.3,29,0.4,2243,34.3
E02006688,4693,100,2963,63.1,2863,61,100,2.1,62,1.3,45,1,17,0.4,1668,35.5
E02006689,5749,100,3323,57.8,3221,56,102,1.8,80,1.4,59,1,21,0.4,2346,40.8
E02006690,5925,100,3403,57.4,3296,55.6,107,1.8,70,1.2,53,0.9,17,0.3,2452,41.4
E02006692,4521,100,2697,59.7,2595,57.4,102,2.3,61,1.3,50,1.1,11,0.2,1763,39
E02006693,5407,100,3340,61.8,3229,59.7,111,2.1,67,1.2,51,0.9,16,0.3,2000,37
E02006694,5277,100,2960,56.1,2847,54,113,2.1,62,1.2,46,0.9,16,0.3,2255,42.7
E02006695,5486,100,3078,56.1,3007,54.8,71,1.3,50,0.9,30,0.5,20,0.4,2358,43
E02007023,6191,100,3975,64.2,3826,61.8,149,2.4,91,1.5,75,1.2,16,0.3,2125,34.3
E02007024,5788,100,3621,62.6,3527,60.9,94,1.6,80,1.4,66,1.1,14,0.2,2087,36.1
E02007025,6532,100,4544,69.6,4385,67.1,159,2.4,119,1.8,95,1.5,24,0.4,1869,28.6
E02007026,6439,100,5022,78,4875,75.7,147,2.3,95,1.5,79,1.2,16,0.2,1322,20.5
E02003172,5324,100,2911,54.7,2781,52.2,130,2.4,86,1.6,74,1.4,12,0.2,2327,43.7
E02003173,5774,100,3084,53.4,2945,51,139,2.4,66,1.1,51,0.9,15,0.3,2624,45.4
E02003174,6919,100,3903,56.4,3764,54.4,139,2,129,1.9,94,1.4,35,0.5,2887,41.7
E02003175,7336,100,4630,63.1,4469,60.9,161,2.2,131,1.8,102,1.4,29,0.4,2575,35.1
E02003176,5870,100,3226,55,3006,51.2,220,3.7,141,2.4,101,1.7,40,0.7,2503,42.6
E02003177,6634,100,4266,64.3,4099,61.8,167,2.5,188,2.8,136,2.1,52,0.8,2180,32.9
E02003178,7110,100,3860,54.3,3706,52.1,154,2.2,280,3.9,203,2.9,77,1.1,2970,41.8
E02003179,5240,100,2815,53.7,2645,50.5,170,3.2,76,1.5,54,1,22,0.4,2349,44.8
E02003180,8503,100,4028,47.4,3801,44.7,227,2.7,807,9.5,554,6.5,253,3,3668,43.1
E02003181,7170,100,4215,58.8,4041,56.4,174,2.4,306,4.3,219,3.1,87,1.2,2649,36.9
E02003182,5334,100,3296,61.8,3174,59.5,122,2.3,109,2,84,1.6,25,0.5,1929,36.2
E02003183,6355,100,3102,48.8,2966,46.7,136,2.1,401,6.3,271,4.3,130,2,2852,44.9
E02003184,6794,100,3983,58.6,3788,55.8,195,2.9,424,6.2,304,4.5,120,1.8,2387,35.1
E02003185,6115,100,3892,63.6,3762,61.5,130,2.1,120,2,84,1.4,36,0.6,2103,34.4
E02003186,7583,100,4922,64.9,4621,60.9,301,4,238,3.1,180,2.4,58,0.8,2423,32
E02003187,7762,100,4623,59.6,4382,56.5,241,3.1,203,2.6,154,2,49,0.6,2936,37.8
E02003188,12149,100,6193,51,5754,47.4,439,3.6,952,7.8,581,4.8,371,3.1,5004,41.2
E02003189,7342,100,4151,56.5,3983,54.2,168,2.3,127,1.7,104,1.4,23,0.3,3064,41.7
E02003190,8904,100,5669,63.7,5248,58.9,421,4.7,215,2.4,165,1.9,50,0.6,3020,33.9
E02003191,7199,100,3671,51,3518,48.9,153,2.1,108,1.5,87,1.2,21,0.3,3420,47.5
E02003192,11930,100,5481,45.9,5103,42.8,378,3.2,1007,8.4,617,5.2,390,3.3,5442,45.6
E02003194,5281,100,2610,49.4,2537,48,73,1.4,81,1.5,59,1.1,22,0.4,2590,49
E02003195,4793,100,2977,62.1,2862,59.7,115,2.4,80,1.7,59,1.2,21,0.4,1736,36.2
E02003196,8830,100,4603,52.1,4474,50.7,129,1.5,192,2.2,149,1.7,43,0.5,4035,45.7
E02003197,5549,100,3244,58.5,3133,56.5,111,2,100,1.8,66,1.2,34,0.6,2205,39.7
E02003198,6062,100,3927,64.8,3771,62.2,156,2.6,114,1.9,94,1.6,20,0.3,2021,33.3
E02003199,7833,100,4644,59.3,4463,57,181,2.3,118,1.5,86,1.1,32,0.4,3071,39.2
E02003200,8374,100,4799,57.3,4577,54.7,222,2.7,197,2.4,156,1.9,41,0.5,3378,40.3
E02003201,9040,100,5662,62.6,5397,59.7,265,2.9,162,1.8,126,1.4,36,0.4,3216,35.6
E02003202,5163,100,2936,56.9,2824,54.7,112,2.2,156,3,101,2,55,1.1,2071,40.1
E02003203,6207,100,4127,66.5,3989,64.3,138,2.2,92,1.5,68,1.1,24,0.4,1988,32
E02003204,7711,100,4628,60,4442,57.6,186,2.4,109,1.4,82,1.1,27,0.4,2974,38.6
E02003205,6952,100,4196,60.4,4061,58.4,135,1.9,119,1.7,85,1.2,34,0.5,2637,37.9
E02003206,8216,100,5125,62.4,4955,60.3,170,2.1,175,2.1,130,1.6,45,0.5,2916,35.5
E02003207,5869,100,3645,62.1,3464,59,181,3.1,93,1.6,71,1.2,22,0.4,2131,36.3
E02003208,9656,100,5415,56.1,5164,53.5,251,2.6,192,2,142,1.5,50,0.5,4049,41.9
E02003209,5625,100,3268,58.1,3109,55.3,159,2.8,84,1.5,71,1.3,13,0.2,2273,40.4
E02003210,8196,100,4641,56.6,4481,54.7,160,2,120,1.5,102,1.2,18,0.2,3435,41.9
E02003211,7722,100,3128,40.5,2990,38.7,138,1.8,77,1,53,0.7,24,0.3,4517,58.5
E02004236,5337,100,2808,52.6,2722,51,86,1.6,76,1.4,56,1,20,0.4,2453,46
E02004237,6668,100,3659,54.9,3518,52.8,141,2.1,151,2.3,123,1.8,28,0.4,2858,42.9
E02004238,6688,100,2691,40.2,2596,38.8,95,1.4,83,1.2,67,1,16,0.2,3914,58.5
E02004239,5363,100,2612,48.7,2526,47.1,86,1.6,80,1.5,63,1.2,17,0.3,2671,49.8
E02004240,4910,100,2781,56.6,2632,53.6,149,3,86,1.8,60,1.2,26,0.5,2043,41.6
E02004241,7821,100,4265,54.5,4088,52.3,177,2.3,133,1.7,101,1.3,32,0.4,3423,43.8
E02004242,5719,100,2466,43.1,2383,41.7,83,1.5,70,1.2,48,0.8,22,0.4,3183,55.7
E02006883,5169,100,3129,60.5,2945,57,184,3.6,77,1.5,61,1.2,16,0.3,1963,38
E02006885,6794,100,4031,59.3,3773,55.5,258,3.8,139,2,92,1.4,47,0.7,2624,38.6
E02004243,5412,100,3185,58.9,3082,56.9,103,1.9,72,1.3,59,1.1,13,0.2,2155,39.8
E02004244,6441,100,3697,57.4,3611,56.1,86,1.3,111,1.7,88,1.4,23,0.4,2633,40.9
E02004245,6228,100,3362,54,3256,52.3,106,1.7,130,2.1,102,1.6,28,0.4,2736,43.9
E02004246,6947,100,3145,45.3,3051,43.9,94,1.4,65,0.9,50,0.7,15,0.2,3737,53.8
E02004247,5130,100,2936,57.2,2857,55.7,79,1.5,73,1.4,53,1,20,0.4,2121,41.3
E02004248,6632,100,2824,42.6,2717,41,107,1.6,64,1,50,0.8,14,0.2,3744,56.5
E02004249,4993,100,2780,55.7,2712,54.3,68,1.4,88,1.8,73,1.5,15,0.3,2125,42.6
E02004250,6719,100,2946,43.8,2842,42.3,104,1.5,76,1.1,60,0.9,16,0.2,3697,55
E02004251,5356,100,2906,54.3,2843,53.1,63,1.2,70,1.3,58,1.1,12,0.2,2380,44.4
E02004252,6666,100,3545,53.2,3429,51.4,116,1.7,122,1.8,69,1,53,0.8,2999,45
E02004253,8542,100,4020,47.1,3917,45.9,103,1.2,124,1.5,105,1.2,19,0.2,4398,51.5
E02004254,8593,100,5027,58.5,4895,57,132,1.5,165,1.9,141,1.6,24,0.3,3401,39.6
E02004255,6197,100,3340,53.9,3225,52,115,1.9,70,1.1,54,0.9,16,0.3,2787,45
E02004256,7681,100,4468,58.2,4359,56.8,109,1.4,90,1.2,68,0.9,22,0.3,3123,40.7
E02004257,7498,100,4412,58.8,4230,56.4,182,2.4,100,1.3,78,1,22,0.3,2986,39.8
E02004258,8952,100,4621,51.6,4509,50.4,112,1.3,112,1.3,86,1,26,0.3,4219,47.1
E02004259,6098,100,2934,48.1,2846,46.7,88,1.4,60,1,39,0.6,21,0.3,3104,50.9
E02004260,7365,100,4177,56.7,4074,55.3,103,1.4,207,2.8,188,2.6,19,0.3,2981,40.5
E02004261,8484,100,5018,59.1,4855,57.2,163,1.9,106,1.2,85,1,21,0.2,3360,39.6
E02004262,6811,100,3727,54.7,3614,53.1,113,1.7,88,1.3,64,0.9,24,0.4,2996,44
E02004263,4859,100,2702,55.6,2624,54,78,1.6,70,1.4,53,1.1,17,0.3,2087,43
E02004264,7155,100,4152,58,3996,55.8,156,2.2,122,1.7,94,1.3,28,0.4,2881,40.3
E02004265,7222,100,3764,52.1,3636,50.3,128,1.8,90,1.2,60,0.8,30,0.4,3368,46.6
E02004266,6822,100,4091,60,3941,57.8,150,2.2,119,1.7,102,1.5,17,0.2,2612,38.3
E02004267,4484,100,2230,49.7,2167,48.3,63,1.4,60,1.3,43,1,17,0.4,2194,48.9
E02004268,8255,100,3868,46.9,3681,44.6,187,2.3,87,1.1,72,0.9,15,0.2,4300,52.1
E02004269,8538,100,3948,46.2,3760,44,188,2.2,106,1.2,77,0.9,29,0.3,4484,52.5
E02004270,6683,100,3541,53,3442,51.5,99,1.5,59,0.9,47,0.7,12,0.2,3083,46.1
E02004271,8667,100,4445,51.3,4266,49.2,179,2.1,66,0.8,55,0.6,11,0.1,4156,48
E02004272,10324,100,5794,56.1,5634,54.6,160,1.5,129,1.2,100,1,29,0.3,4401,42.6
E02004273,6339,100,2894,45.7,2784,43.9,110,1.7,54,0.9,38,0.6,16,0.3,3391,53.5
E02004274,5502,100,2720,49.4,2594,47.1,126,2.3,61,1.1,51,0.9,10,0.2,2721,49.5
E02004275,6647,100,3358,50.5,3252,48.9,106,1.6,67,1,57,0.9,10,0.2,3222,48.5
E02004276,4899,100,2306,47.1,2203,45,103,2.1,36,0.7,29,0.6,7,0.1,2557,52.2
E02004278,7329,100,4075,55.6,3985,54.4,90,1.2,164,2.2,118,1.6,46,0.6,3090,42.2
E02004279,6817,100,3682,54,3578,52.5,104,1.5,101,1.5,76,1.1,25,0.4,3034,44.5
E02004280,7120,100,3907,54.9,3799,53.4,108,1.5,94,1.3,79,1.1,15,0.2,3119,43.8
E02004281,6259,100,3647,58.3,3488,55.7,159,2.5,98,1.6,63,1,35,0.6,2514,40.2
E02004282,7861,100,3566,45.4,3469,44.1,97,1.2,91,1.2,81,1,10,0.1,4204,53.5
E02004283,7540,100,3948,52.4,3754,49.8,194,2.6,126,1.7,106,1.4,20,0.3,3466,46
E02004284,8330,100,4257,51.1,3968,47.6,289,3.5,90,1.1,66,0.8,24,0.3,3983,47.8
E02004285,6541,100,3738,57.1,3572,54.6,166,2.5,105,1.6,79,1.2,26,0.4,2698,41.2
E02004286,4242,100,2310,54.5,2222,52.4,88,2.1,69,1.6,55,1.3,14,0.3,1863,43.9
E02004287,4664,100,2597,55.7,2497,53.5,100,2.1,84,1.8,63,1.4,21,0.5,1983,42.5
E02004288,5263,100,2625,49.9,2449,46.5,176,3.3,61,1.2,42,0.8,19,0.4,2577,49
E02004289,6125,100,3398,55.5,3279,53.5,119,1.9,89,1.5,69,1.1,20,0.3,2638,43.1
E02007006,5056,100,2494,49.3,2370,46.9,124,2.5,73,1.4,43,0.9,30,0.6,2489,49.2
E02007007,5604,100,3065,54.7,2960,52.8,105,1.9,121,2.2,93,1.7,28,0.5,2418,43.1
E02004129,5155,100,2865,55.6,2798,54.3,67,1.3,55,1.1,46,0.9,9,0.2,2235,43.4
E02004130,5245,100,2670,50.9,2573,49.1,97,1.8,51,1,41,0.8,10,0.2,2524,48.1
E02004131,4650,100,2614,56.2,2539,54.6,75,1.6,73,1.6,59,1.3,14,0.3,1963,42.2
E02004132,7412,100,4354,58.7,4240,57.2,114,1.5,91,1.2,80,1.1,11,0.1,2967,40
E02004133,8249,100,4428,53.7,4228,51.3,200,2.4,93,1.1,75,0.9,18,0.2,3728,45.2
E02004135,7294,100,3475,47.6,3349,45.9,126,1.7,59,0.8,41,0.6,18,0.2,3760,51.5
E02004136,7773,100,4171,53.7,4053,52.1,118,1.5,116,1.5,102,1.3,14,0.2,3486,44.8
E02004137,4685,100,2295,49,2217,47.3,78,1.7,46,1,38,0.8,8,0.2,2344,50
E02004138,6905,100,2841,41.1,2735,39.6,106,1.5,69,1,57,0.8,12,0.2,3995,57.9
E02004139,5978,100,2726,45.6,2616,43.8,110,1.8,87,1.5,77,1.3,10,0.2,3165,52.9
E02004140,4813,100,1731,36,1665,34.6,66,1.4,40,0.8,37,0.8,3,0.1,3042,63.2
E02004141,5303,100,2795,52.7,2709,51.1,86,1.6,79,1.5,68,1.3,11,0.2,2429,45.8
E02004142,5451,100,3198,58.7,3127,57.4,71,1.3,70,1.3,65,1.2,5,0.1,2183,40
E02004143,5349,100,2849,53.3,2780,52,69,1.3,55,1,39,0.7,16,0.3,2445,45.7
E02004144,5816,100,2990,51.4,2913,50.1,77,1.3,97,1.7,80,1.4,17,0.3,2729,46.9
E02004145,5418,100,2182,40.3,2126,39.2,56,1,54,1,39,0.7,15,0.3,3182,58.7
E02004146,6134,100,3628,59.1,3466,56.5,162,2.6,73,1.2,63,1,10,0.2,2433,39.7
E02004147,5939,100,3670,61.8,3492,58.8,178,3,75,1.3,61,1,14,0.2,2194,36.9
E02004148,6817,100,2818,41.3,2702,39.6,116,1.7,80,1.2,64,0.9,16,0.2,3919,57.5
E02007027,8724,100,5752,65.9,5606,64.3,146,1.7,184,2.1,159,1.8,25,0.3,2788,32
E02007028,4273,100,3506,82.1,3431,80.3,75,1.8,69,1.6,59,1.4,10,0.2,698,16.3
E02004149,10180,100,2746,27,2668,26.2,78,0.8,951,9.3,595,5.8,356,3.5,6483,63.7
E02004150,5889,100,3090,52.5,2969,50.4,121,2.1,293,5,213,3.6,80,1.4,2506,42.6
E02004151,8056,100,4974,61.7,4826,59.9,148,1.8,118,1.5,93,1.2,25,0.3,2964,36.8
E02004152,9200,100,2460,26.7,2320,25.2,140,1.5,1040,11.3,753,8.2,287,3.1,5700,62
E02004153,6038,100,3935,65.2,3790,62.8,145,2.4,112,1.9,100,1.7,12,0.2,1991,33
E02004154,7165,100,3844,53.6,3725,52,119,1.7,487,6.8,372,5.2,115,1.6,2834,39.6
E02004155,6047,100,3589,59.4,3431,56.7,158,2.6,78,1.3,50,0.8,28,0.5,2380,39.4
E02004156,10862,100,4177,38.5,3920,36.1,257,2.4,949,8.7,615,5.7,334,3.1,5736,52.8
E02004157,5365,100,3240,60.4,3139,58.5,101,1.9,168,3.1,135,2.5,33,0.6,1957,36.5
E02004158,6699,100,4518,67.4,4376,65.3,142,2.1,150,2.2,126,1.9,24,0.4,2031,30.3
E02004159,10275,100,6854,66.7,6668,64.9,186,1.8,204,2,157,1.5,47,0.5,3217,31.3
E02004160,5992,100,3439,57.4,3335,55.7,104,1.7,95,1.6,78,1.3,17,0.3,2458,41
E02004161,6739,100,4022,59.7,3840,57,182,2.7,114,1.7,98,1.5,16,0.2,2603,38.6
E02004162,5952,100,3653,61.4,3547,59.6,106,1.8,89,1.5,75,1.3,14,0.2,2210,37.1
E02004163,6871,100,3764,54.8,3624,52.7,140,2,103,1.5,69,1,34,0.5,3004,43.7
E02004164,5744,100,3287,57.2,3214,56,73,1.3,61,1.1,51,0.9,10,0.2,2396,41.7
E02004165,7475,100,4434,59.3,4322,57.8,112,1.5,106,1.4,91,1.2,15,0.2,2935,39.3
E02004166,5537,100,3331,60.2,3260,58.9,71,1.3,66,1.2,54,1,12,0.2,2140,38.6
E02004167,5657,100,3261,57.6,3122,55.2,139,2.5,94,1.7,66,1.2,28,0.5,2302,40.7
E02004168,5111,100,2952,57.8,2819,55.2,133,2.6,66,1.3,56,1.1,10,0.2,2093,41
E02004169,6217,100,3833,61.7,3731,60,102,1.6,109,1.8,93,1.5,16,0.3,2275,36.6
E02004170,7163,100,4521,63.1,4386,61.2,135,1.9,103,1.4,86,1.2,17,0.2,2539,35.4
E02004171,6986,100,4225,60.5,4111,58.8,114,1.6,125,1.8,95,1.4,30,0.4,2636,37.7
E02004172,5460,100,3159,57.9,3064,56.1,95,1.7,78,1.4,61,1.1,17,0.3,2223,40.7
E02004173,6245,100,3721,59.6,3630,58.1,91,1.5,88,1.4,71,1.1,17,0.3,2436,39
E02004174,6601,100,3925,59.5,3806,57.7,119,1.8,99,1.5,81,1.2,18,0.3,2577,39
E02004175,4365,100,2375,54.4,2230,51.1,145,3.3,32,0.7,22,0.5,10,0.2,1958,44.9
E02004176,4833,100,2557,52.9,2461,50.9,96,2,39,0.8,26,0.5,13,0.3,2237,46.3
E02004177,4906,100,2721,55.5,2577,52.5,144,2.9,60,1.2,46,0.9,14,0.3,2125,43.3
E02004178,4418,100,2460,55.7,2390,54.1,70,1.6,68,1.5,57,1.3,11,0.2,1890,42.8
E02004179,7552,100,4329,57.3,4197,55.6,132,1.7,157,2.1,130,1.7,27,0.4,3066,40.6
E02004180,5428,100,3163,58.3,3113,57.4,50,0.9,89,1.6,64,1.2,25,0.5,2176,40.1
E02004181,4729,100,2737,57.9,2649,56,88,1.9,58,1.2,50,1.1,8,0.2,1934,40.9
E02004182,5169,100,2929,56.7,2765,53.5,164,3.2,74,1.4,50,1,24,0.5,2166,41.9
E02004183,5012,100,2586,51.6,2494,49.8,92,1.8,68,1.4,57,1.1,11,0.2,2358,47
E02004184,6835,100,4097,59.9,3920,57.4,177,2.6,123,1.8,99,1.4,24,0.4,2615,38.3
E02004185,5701,100,2810,49.3,2704,47.4,106,1.9,67,1.2,49,0.9,18,0.3,2824,49.5
E02004186,8295,100,4994,60.2,4837,58.3,157,1.9,136,1.6,97,1.2,39,0.5,3165,38.2
E02004187,8910,100,5011,56.2,4845,54.4,166,1.9,112,1.3,79,0.9,33,0.4,3787,42.5
E02004188,6039,100,3220,53.3,3104,51.4,116,1.9,63,1,47,0.8,16,0.3,2756,45.6
E02004189,5130,100,3211,62.6,3144,61.3,67,1.3,92,1.8,84,1.6,8,0.2,1827,35.6
E02004190,7355,100,4193,57,4088,55.6,105,1.4,104,1.4,85,1.2,19,0.3,3058,41.6
E02004191,7656,100,4066,53.1,3883,50.7,183,2.4,105,1.4,75,1,30,0.4,3485,45.5
E02004192,6640,100,3472,52.3,3374,50.8,98,1.5,74,1.1,60,0.9,14,0.2,3094,46.6
E02004193,9756,100,5886,60.3,5732,58.8,154,1.6,177,1.8,150,1.5,27,0.3,3693,37.9
E02004194,6080,100,3527,58,3417,56.2,110,1.8,83,1.4,69,1.1,14,0.2,2470,40.6
E02004195,4626,100,2328,50.3,2240,48.4,88,1.9,78,1.7,68,1.5,10,0.2,2220,48
E02004196,6729,100,3684,54.7,3583,53.2,101,1.5,59,0.9,45,0.7,14,0.2,2986,44.4
E02004197,6140,100,3140,51.1,3042,49.5,98,1.6,89,1.4,73,1.2,16,0.3,2911,47.4
E02004198,5337,100,2873,53.8,2797,52.4,76,1.4,80,1.5,69,1.3,11,0.2,2384,44.7
E02004199,5036,100,2397,47.6,2321,46.1,76,1.5,41,0.8,35,0.7,6,0.1,2598,51.6
E02004200,4479,100,2210,49.3,2126,47.5,84,1.9,40,0.9,23,0.5,17,0.4,2229,49.8
E02004201,4727,100,2538,53.7,2484,52.5,54,1.1,56,1.2,49,1,7,0.1,2133,45.1
E02004202,7157,100,4281,59.8,4161,58.1,120,1.7,130,1.8,110,1.5,20,0.3,2746,38.4
E02004203,4983,100,2710,54.4,2646,53.1,64,1.3,40,0.8,24,0.5,16,0.3,2233,44.8
E02004204,8170,100,4693,57.4,4557,55.8,136,1.7,133,1.6,114,1.4,19,0.2,3344,40.9
E02004205,7222,100,3782,52.4,3649,50.5,133,1.8,97,1.3,74,1,23,0.3,3343,46.3
E02004206,5933,100,2749,46.3,2623,44.2,126,2.1,77,1.3,61,1,16,0.3,3107,52.4
E02004207,5614,100,3167,56.4,3073,54.7,94,1.7,65,1.2,53,0.9,12,0.2,2382,42.4
E02004208,7109,100,3613,50.8,3481,49,132,1.9,96,1.4,70,1,26,0.4,3400,47.8
E02004209,7595,100,4584,60.4,4438,58.4,146,1.9,122,1.6,106,1.4,16,0.2,2889,38
E02004210,5586,100,2970,53.2,2798,50.1,172,3.1,57,1,42,0.8,15,0.3,2559,45.8
E02004211,5770,100,2736,47.4,2664,46.2,72,1.2,60,1,48,0.8,12,0.2,2974,51.5
E02004212,5094,100,3100,60.9,3017,59.2,83,1.6,67,1.3,56,1.1,11,0.2,1927,37.8
E02004213,7380,100,4624,62.7,4471,60.6,153,2.1,90,1.2,65,0.9,25,0.3,2666,36.1
E02004214,5045,100,3143,62.3,3001,59.5,142,2.8,78,1.5,56,1.1,22,0.4,1824,36.2
E02004215,4916,100,2768,56.3,2673,54.4,95,1.9,81,1.6,62,1.3,19,0.4,2067,42
E02004216,4698,100,2562,54.5,2483,52.9,79,1.7,65,1.4,60,1.3,5,0.1,2071,44.1
E02004217,6467,100,3669,56.7,3531,54.6,138,2.1,92,1.4,70,1.1,22,0.3,2706,41.8
E02004218,5191,100,2764,53.2,2677,51.6,87,1.7,85,1.6,76,1.5,9,0.2,2342,45.1
E02004219,4802,100,2517,52.4,2449,51,68,1.4,66,1.4,59,1.2,7,0.1,2219,46.2
E02004220,5236,100,2486,47.5,2369,45.2,117,2.2,56,1.1,40,0.8,16,0.3,2694,51.5
E02004221,5640,100,2467,43.7,2377,42.1,90,1.6,71,1.3,54,1,17,0.3,3102,55
E02004222,4848,100,2664,55,2531,52.2,133,2.7,62,1.3,49,1,13,0.3,2122,43.8
E02004223,10380,100,6059,58.4,5782,55.7,277,2.7,145,1.4,109,1.1,36,0.3,4176,40.2
E02004224,5562,100,3026,54.4,2920,52.5,106,1.9,54,1,43,0.8,11,0.2,2482,44.6
E02004225,4772,100,2684,56.2,2585,54.2,99,2.1,59,1.2,47,1,12,0.3,2029,42.5
E02004226,6324,100,3349,53,3240,51.2,109,1.7,54,0.9,34,0.5,20,0.3,2921,46.2
E02004227,8513,100,4683,55,4493,52.8,190,2.2,99,1.2,85,1,14,0.2,3731,43.8
E02004228,6277,100,3332,53.1,3245,51.7,87,1.4,70,1.1,52,0.8,18,0.3,2875,45.8
E02004229,8275,100,4838,58.5,4710,56.9,128,1.5,88,1.1,69,0.8,19,0.2,3349,40.5
E02004230,6392,100,3563,55.7,3427,53.6,136,2.1,69,1.1,66,1,3,0,2760,43.2
E02004231,6131,100,3212,52.4,3085,50.3,127,2.1,66,1.1,53,0.9,13,0.2,2853,46.5
E02004232,5940,100,3332,56.1,3242,54.6,90,1.5,86,1.4,76,1.3,10,0.2,2522,42.5
E02004233,10659,100,5358,50.3,5156,48.4,202,1.9,127,1.2,104,1,23,0.2,5174,48.5
E02004234,5391,100,2682,49.7,2589,48,93,1.7,44,0.8,41,0.8,3,0.1,2665,49.4
E02004235,5577,100,2771,49.7,2698,48.4,73,1.3,83,1.5,70,1.3,13,0.2,2723,48.8
E02004600,4584,100,2872,62.7,2785,60.8,87,1.9,44,1,34,0.7,10,0.2,1668,36.4
E02004601,5219,100,2630,50.4,2571,49.3,59,1.1,175,3.4,95,1.8,80,1.5,2414,46.3
E02004602,5351,100,3342,62.5,3190,59.6,152,2.8,90,1.7,73,1.4,17,0.3,1919,35.9
E02004603,7055,100,3551,50.3,3361,47.6,190,2.7,670,9.5,508,7.2,162,2.3,2834,40.2
E02004604,6350,100,3909,61.6,3679,57.9,230,3.6,113,1.8,91,1.4,22,0.3,2328,36.7
E02004605,4588,100,2731,59.5,2584,56.3,147,3.2,80,1.7,66,1.4,14,0.3,1777,38.7
E02004606,8822,100,5981,67.8,5750,65.2,231,2.6,214,2.4,175,2,39,0.4,2627,29.8
E02004607,8435,100,5696,67.5,5480,65,216,2.6,161,1.9,123,1.5,38,0.5,2578,30.6
E02004608,8607,100,5347,62.1,5149,59.8,198,2.3,145,1.7,122,1.4,23,0.3,3115,36.2
E02004609,5951,100,3662,61.5,3559,59.8,103,1.7,122,2.1,103,1.7,19,0.3,2167,36.4
E02004610,6510,100,3549,54.5,3434,52.7,115,1.8,127,2,92,1.4,35,0.5,2834,43.5
E02004611,9507,100,6146,64.6,5974,62.8,172,1.8,188,2,144,1.5,44,0.5,3173,33.4
E02004612,7689,100,4522,58.8,4405,57.3,117,1.5,129,1.7,110,1.4,19,0.2,3038,39.5
E02004613,5292,100,2975,56.2,2911,55,64,1.2,101,1.9,69,1.3,32,0.6,2216,41.9
E02004614,4482,100,2538,56.6,2471,55.1,67,1.5,67,1.5,53,1.2,14,0.3,1877,41.9
E02004615,7436,100,3934,52.9,3813,51.3,121,1.6,85,1.1,70,0.9,15,0.2,3417,46
E02004616,8546,100,4874,57,4707,55.1,167,2,92,1.1,76,0.9,16,0.2,3580,41.9
E02004617,7826,100,4741,60.6,4629,59.1,112,1.4,93,1.2,78,1,15,0.2,2992,38.2
E02004618,6129,100,3704,60.4,3605,58.8,99,1.6,80,1.3,60,1,20,0.3,2345,38.3
E02004619,6120,100,3606,58.9,3506,57.3,100,1.6,72,1.2,59,1,13,0.2,2442,39.9
E02004620,6856,100,4282,62.5,4148,60.5,134,2,149,2.2,127,1.9,22,0.3,2425,35.4
E02004621,5380,100,2778,51.6,2661,49.5,117,2.2,117,2.2,93,1.7,24,0.4,2485,46.2
E02004622,6328,100,3767,59.5,3621,57.2,146,2.3,119,1.9,88,1.4,31,0.5,2442,38.6
E02004623,7664,100,4409,57.5,4279,55.8,130,1.7,111,1.4,81,1.1,30,0.4,3144,41
E02004624,5460,100,3273,59.9,3178,58.2,95,1.7,74,1.4,62,1.1,12,0.2,2113,38.7
E02004625,8561,100,5192,60.6,5052,59,140,1.6,96,1.1,84,1,12,0.1,3273,38.2
E02004626,8646,100,4305,49.8,4192,48.5,113,1.3,284,3.3,192,2.2,92,1.1,4057,46.9
E02004627,5278,100,3048,57.7,2937,55.6,111,2.1,72,1.4,66,1.3,6,0.1,2158,40.9
E02004628,6565,100,3770,57.4,3631,55.3,139,2.1,65,1,47,0.7,18,0.3,2730,41.6
E02004629,10666,100,6112,57.3,5826,54.6,286,2.7,123,1.2,100,0.9,23,0.2,4431,41.5
E02004630,5684,100,3126,55,3041,53.5,85,1.5,61,1.1,51,0.9,10,0.2,2497,43.9
E02004631,4425,100,2396,54.1,2299,52,97,2.2,50,1.1,42,0.9,8,0.2,1979,44.7
E02004632,9023,100,4981,55.2,4790,53.1,191,2.1,97,1.1,72,0.8,25,0.3,3945,43.7
E02004633,7048,100,3962,56.2,3826,54.3,136,1.9,93,1.3,71,1,22,0.3,2993,42.5
E02004634,9373,100,5446,58.1,5178,55.2,268,2.9,97,1,74,0.8,23,0.2,3830,40.9
E02004635,6337,100,3610,57,3489,55.1,121,1.9,78,1.2,63,1,15,0.2,2649,41.8
E02004636,6592,100,3998,60.6,3929,59.6,69,1,165,2.5,108,1.6,57,0.9,2429,36.8
E02004637,7960,100,4481,56.3,4284,53.8,197,2.5,308,3.9,228,2.9,80,1,3171,39.8
E02004638,4811,100,3018,62.7,2936,61,82,1.7,89,1.8,65,1.4,24,0.5,1704,35.4
E02004639,9958,100,5826,58.5,5495,55.2,331,3.3,474,4.8,351,3.5,123,1.2,3658,36.7
E02004640,6573,100,3928,59.8,3647,55.5,281,4.3,178,2.7,133,2,45,0.7,2467,37.5
E02004641,6255,100,3388,54.2,3300,52.8,88,1.4,77,1.2,53,0.8,24,0.4,2790,44.6
E02004642,9655,100,6223,64.5,5982,62,241,2.5,228,2.4,154,1.6,74,0.8,3204,33.2
E02004643,6330,100,3893,61.5,3656,57.8,237,3.7,137,2.2,96,1.5,41,0.6,2300,36.3
E02004644,7292,100,4675,64.1,4478,61.4,197,2.7,163,2.2,124,1.7,39,0.5,2454,33.7
E02004645,7491,100,4836,64.6,4700,62.7,136,1.8,127,1.7,97,1.3,30,0.4,2528,33.7
E02004646,7277,100,4263,58.6,4056,55.7,207,2.8,129,1.8,95,1.3,34,0.5,2885,39.6
E02004647,5067,100,2869,56.6,2754,54.4,115,2.3,93,1.8,66,1.3,27,0.5,2105,41.5
E02004648,4746,100,2655,55.9,2585,54.5,70,1.5,74,1.6,58,1.2,16,0.3,2017,42.5
E02004649,5891,100,4291,72.8,4171,70.8,120,2,124,2.1,87,1.5,37,0.6,1476,25.1
E02004650,11034,100,7965,72.2,7710,69.9,255,2.3,279,2.5,222,2,57,0.5,2790,25.3
E02004651,8743,100,6082,69.6,5942,68,140,1.6,148,1.7,121,1.4,27,0.3,2513,28.7
E02004652,5692,100,2997,52.7,2900,50.9,97,1.7,74,1.3,55,1,19,0.3,2621,46
E02004653,6442,100,3938,61.1,3825,59.4,113,1.8,101,1.6,85,1.3,16,0.2,2403,37.3
E02004654,9543,100,5752,60.3,5563,58.3,189,2,182,1.9,152,1.6,30,0.3,3609,37.8
E02004655,6677,100,4065,60.9,3939,59,126,1.9,104,1.6,79,1.2,25,0.4,2508,37.6
E02004656,9503,100,5937,62.5,5698,60,239,2.5,167,1.8,126,1.3,41,0.4,3399,35.8
E02004657,5598,100,3538,63.2,3449,61.6,89,1.6,86,1.5,71,1.3,15,0.3,1974,35.3
E02004658,5233,100,3240,61.9,3161,60.4,79,1.5,107,2,83,1.6,24,0.5,1886,36
E02004659,5926,100,3449,58.2,3364,56.8,85,1.4,81,1.4,64,1.1,17,0.3,2396,40.4
E02004660,5614,100,2803,49.9,2718,48.4,85,1.5,84,1.5,63,1.1,21,0.4,2727,48.6
E02004661,7153,100,4153,58.1,4012,56.1,141,2,86,1.2,65,0.9,21,0.3,2914,40.7
E02004662,5489,100,3397,61.9,3293,60,104,1.9,60,1.1,43,0.8,17,0.3,2032,37
E02004663,5410,100,3224,59.6,3124,57.7,100,1.8,65,1.2,47,0.9,18,0.3,2121,39.2
E02004664,6014,100,3690,61.4,3589,59.7,101,1.7,87,1.4,72,1.2,15,0.2,2237,37.2
E02004665,7156,100,4234,59.2,4128,57.7,106,1.5,101,1.4,83,1.2,18,0.3,2821,39.4
E02004666,9738,100,6535,67.1,6346,65.2,189,1.9,156,1.6,127,1.3,29,0.3,3047,31.3
E02004667,9007,100,5048,56,4863,54,185,2.1,85,0.9,61,0.7,24,0.3,3874,43
E02004668,7688,100,4149,54,4024,52.3,125,1.6,95,1.2,78,1,17,0.2,3444,44.8
E02004669,6241,100,3542,56.8,3433,55,109,1.7,97,1.6,78,1.2,19,0.3,2602,41.7
E02004671,5906,100,3472,58.8,3390,57.4,82,1.4,86,1.5,72,1.2,14,0.2,2348,39.8
E02004672,10049,100,6146,61.2,5959,59.3,187,1.9,151,1.5,114,1.1,37,0.4,3752,37.3
E02004673,6271,100,3781,60.3,3659,58.3,122,1.9,89,1.4,67,1.1,22,0.4,2401,38.3
E02004674,9713,100,6414,66,6199,63.8,215,2.2,150,1.5,127,1.3,23,0.2,3149,32.4
E02007034,6273,100,4429,70.6,4304,68.6,125,2,110,1.8,83,1.3,27,0.4,1734,27.6
E02007035,6463,100,3607,55.8,3476,53.8,131,2,86,1.3,68,1.1,18,0.3,2770,42.9
E02006047,7322,100,4287,58.5,4158,56.8,129,1.8,105,1.4,83,1.1,22,0.3,2930,40
E02006048,5886,100,3471,59,3360,57.1,111,1.9,74,1.3,65,1.1,9,0.2,2341,39.8
E02006049,6069,100,3515,57.9,3432,56.5,83,1.4,92,1.5,77,1.3,15,0.2,2462,40.6
E02006050,7046,100,4362,61.9,4186,59.4,176,2.5,80,1.1,61,0.9,19,0.3,2604,37
E02006051,7100,100,3870,54.5,3737,52.6,133,1.9,111,1.6,95,1.3,16,0.2,3119,43.9
E02006052,6558,100,3879,59.1,3749,57.2,130,2,88,1.3,79,1.2,9,0.1,2591,39.5
E02006053,8744,100,5591,63.9,5405,61.8,186,2.1,129,1.5,110,1.3,19,0.2,3024,34.6
E02006054,7157,100,3720,52,3572,49.9,148,2.1,106,1.5,86,1.2,20,0.3,3331,46.5
E02006055,7387,100,4929,66.7,4734,64.1,195,2.6,120,1.6,103,1.4,17,0.2,2338,31.7
E02006056,6488,100,3898,60.1,3782,58.3,116,1.8,72,1.1,55,0.8,17,0.3,2518,38.8
E02006057,6525,100,3683,56.4,3498,53.6,185,2.8,75,1.1,60,0.9,15,0.2,2767,42.4
E02006058,7102,100,3933,55.4,3801,53.5,132,1.9,138,1.9,105,1.5,33,0.5,3031,42.7
E02006059,5909,100,3365,56.9,3292,55.7,73,1.2,79,1.3,61,1,18,0.3,2465,41.7
E02006060,6757,100,3948,58.4,3800,56.2,148,2.2,139,2.1,122,1.8,17,0.3,2670,39.5
E02006061,7811,100,4380,56.1,4256,54.5,124,1.6,138,1.8,120,1.5,18,0.2,3293,42.2
E02006062,9532,100,4961,52,4789,50.2,172,1.8,125,1.3,101,1.1,24,0.3,4446,46.6
E02006063,5854,100,3231,55.2,3174,54.2,57,1,129,2.2,101,1.7,28,0.5,2494,42.6
E02006064,6860,100,3218,46.9,3076,44.8,142,2.1,78,1.1,64,0.9,14,0.2,3564,52
E02006065,7244,100,3920,54.1,3707,51.2,213,2.9,94,1.3,70,1,24,0.3,3230,44.6
E02006066,7168,100,3917,54.6,3804,53.1,113,1.6,109,1.5,82,1.1,27,0.4,3142,43.8
E02006067,6001,100,3232,53.9,3146,52.4,86,1.4,136,2.3,106,1.8,30,0.5,2633,43.9
E02006068,6164,100,3633,58.9,3435,55.7,198,3.2,128,2.1,92,1.5,36,0.6,2403,39
E02006069,8678,100,5634,64.9,5337,61.5,297,3.4,157,1.8,125,1.4,32,0.4,2887,33.3
E02006070,7140,100,4741,66.4,4643,65,98,1.4,122,1.7,94,1.3,28,0.4,2277,31.9
E02006071,7844,100,4859,61.9,4764,60.7,95,1.2,187,2.4,160,2,27,0.3,2798,35.7
E02006072,8072,100,4450,55.1,4334,53.7,116,1.4,109,1.4,84,1,25,0.3,3513,43.5
E02006073,6151,100,3677,59.8,3427,55.7,250,4.1,118,1.9,92,1.5,26,0.4,2356,38.3
E02006074,9260,100,6010,64.9,5818,62.8,192,2.1,186,2,149,1.6,37,0.4,3064,33.1
E02006075,4297,100,2497,58.1,2414,56.2,83,1.9,62,1.4,38,0.9,24,0.6,1738,40.4
E02006076,7817,100,4232,54.1,4098,52.4,134,1.7,111,1.4,93,1.2,18,0.2,3474,44.4
E02006077,5212,100,2706,51.9,2633,50.5,73,1.4,79,1.5,59,1.1,20,0.4,2427,46.6
E02006078,5371,100,2914,54.3,2831,52.7,83,1.5,68,1.3,56,1,12,0.2,2389,44.5
E02006079,6911,100,4045,58.5,3926,56.8,119,1.7,94,1.4,77,1.1,17,0.2,2772,40.1
E02006080,5722,100,3637,63.6,3541,61.9,96,1.7,72,1.3,66,1.2,6,0.1,2013,35.2
E02006081,4854,100,2539,52.3,2459,50.7,80,1.6,83,1.7,63,1.3,20,0.4,2232,46
E02006082,5856,100,3338,57,3211,54.8,127,2.2,64,1.1,55,0.9,9,0.2,2454,41.9
E02006083,4834,100,2616,54.1,2543,52.6,73,1.5,54,1.1,46,1,8,0.2,2164,44.8
E02006084,6383,100,3342,52.4,3256,51,86,1.3,75,1.2,61,1,14,0.2,2966,46.5
E02006085,6246,100,3917,62.7,3808,61,109,1.7,95,1.5,74,1.2,21,0.3,2234,35.8
E02006086,6230,100,3852,61.8,3737,60,115,1.8,141,2.3,122,2,19,0.3,2237,35.9
E02006087,4777,100,2952,61.8,2854,59.7,98,2.1,90,1.9,70,1.5,20,0.4,1735,36.3
E02006088,6184,100,3704,59.9,3534,57.1,170,2.7,141,2.3,109,1.8,32,0.5,2339,37.8
E02006089,6036,100,3934,65.2,3721,61.6,213,3.5,104,1.7,76,1.3,28,0.5,1998,33.1
E02006090,5883,100,3604,61.3,3516,59.8,88,1.5,92,1.6,67,1.1,25,0.4,2187,37.2
E02006091,8497,100,4537,53.4,4389,51.7,148,1.7,122,1.4,98,1.2,24,0.3,3838,45.2
E02006092,5472,100,3241,59.2,3182,58.2,59,1.1,87,1.6,69,1.3,18,0.3,2144,39.2
E02006093,7355,100,3995,54.3,3851,52.4,144,2,95,1.3,71,1,24,0.3,3265,44.4
E02006094,4610,100,2463,53.4,2397,52,66,1.4,63,1.4,49,1.1,14,0.3,2084,45.2
E02006095,7072,100,3875,54.8,3726,52.7,149,2.1,64,0.9,50,0.7,14,0.2,3133,44.3
E02006096,6038,100,3511,58.1,3390,56.1,121,2,80,1.3,57,0.9,23,0.4,2447,40.5
E02006097,5679,100,3176,55.9,3023,53.2,153,2.7,76,1.3,46,0.8,30,0.5,2427,42.7
E02006098,6477,100,3353,51.8,3265,50.4,88,1.4,75,1.2,50,0.8,25,0.4,3049,47.1
E02006099,5888,100,3503,59.5,3392,57.6,111,1.9,110,1.9,78,1.3,32,0.5,2275,38.6
E02006100,6610,100,3887,58.8,3786,57.3,101,1.5,104,1.6,76,1.1,28,0.4,2619,39.6
E02006101,4873,100,2709,55.6,2657,54.5,52,1.1,56,1.1,45,0.9,11,0.2,2108,43.3
E02006102,5607,100,3189,56.9,3070,54.8,119,2.1,88,1.6,61,1.1,27,0.5,2330,41.6
E02006103,6696,100,3620,54.1,3533,52.8,87,1.3,117,1.7,97,1.4,20,0.3,2959,44.2
E02006104,8570,100,5700,66.5,5525,64.5,175,2,161,1.9,138,1.6,23,0.3,2709,31.6
E02006105,9342,100,6318,67.6,6089,65.2,229,2.5,136,1.5,111,1.2,25,0.3,2888,30.9
E02006106,7963,100,5093,64,4959,62.3,134,1.7,144,1.8,106,1.3,38,0.5,2726,34.2
E02006107,6545,100,3877,59.2,3673,56.1,204,3.1,116,1.8,91,1.4,25,0.4,2552,39
E02006108,7487,100,4029,53.8,3849,51.4,180,2.4,110,1.5,86,1.1,24,0.3,3348,44.7
E02006109,6554,100,3692,56.3,3579,54.6,113,1.7,120,1.8,102,1.6,18,0.3,2742,41.8
E02006110,8483,100,5177,61,4997,58.9,180,2.1,143,1.7,111,1.3,32,0.4,3163,37.3
E02006111,9143,100,4926,53.9,4772,52.2,154,1.7,138,1.5,111,1.2,27,0.3,4079,44.6
E02006112,7054,100,3892,55.2,3788,53.7,104,1.5,109,1.5,88,1.2,21,0.3,3053,43.3
E02006113,6421,100,3136,48.8,3006,46.8,130,2,69,1.1,54,0.8,15,0.2,3216,50.1
E02006114,5636,100,2458,43.6,2364,41.9,94,1.7,52,0.9,32,0.6,20,0.4,3126,55.5
E02006115,6414,100,3027,47.2,2899,45.2,128,2,48,0.7,28,0.4,20,0.3,3339,52.1
E02006116,7029,100,3512,50,3387,48.2,125,1.8,96,1.4,79,1.1,17,0.2,3421,48.7
E02006117,4971,100,2509,50.5,2443,49.1,66,1.3,41,0.8,31,0.6,10,0.2,2421,48.7
W02000001,7054,100,3559,50.5,3358,47.6,201,2.8,97,1.4,73,1,24,0.3,3398,48.2
W02000002,5481,100,2667,48.7,2555,46.6,112,2,61,1.1,44,0.8,17,0.3,2753,50.2
W02000003,8312,100,4482,53.9,4079,49.1,403,4.8,150,1.8,125,1.5,25,0.3,3680,44.3
W02000004,6295,100,3159,50.2,3022,48,137,2.2,85,1.4,55,0.9,30,0.5,3051,48.5
W02000005,7068,100,3403,48.1,3259,46.1,144,2,105,1.5,83,1.2,22,0.3,3560,50.4
W02000006,5579,100,3182,57,3047,54.6,135,2.4,93,1.7,77,1.4,16,0.3,2304,41.3
W02000007,5605,100,3204,57.2,3075,54.9,129,2.3,71,1.3,67,1.2,4,0.1,2330,41.6
W02000008,5096,100,2656,52.1,2565,50.3,91,1.8,117,2.3,84,1.6,33,0.6,2323,45.6
W02000009,6669,100,3718,55.8,3586,53.8,132,2,65,1,56,0.8,9,0.1,2886,43.3
W02000010,7922,100,2005,25.3,1810,22.8,195,2.5,1179,14.9,743,9.4,436,5.5,4738,59.8
W02000011,6627,100,3719,56.1,3504,52.9,215,3.2,253,3.8,183,2.8,70,1.1,2655,40.1
W02000012,6683,100,4091,61.2,3878,58,213,3.2,124,1.9,102,1.5,22,0.3,2468,36.9
W02000013,5269,100,3216,61,3093,58.7,123,2.3,109,2.1,94,1.8,15,0.3,1944,36.9
W02000014,5582,100,3400,60.9,3260,58.4,140,2.5,108,1.9,91,1.6,17,0.3,2074,37.2
W02000015,6716,100,3799,56.6,3607,53.7,192,2.9,108,1.6,84,1.3,24,0.4,2809,41.8
W02000016,5233,100,3062,58.5,2950,56.4,112,2.1,80,1.5,70,1.3,10,0.2,2091,40
W02000017,6165,100,3488,56.6,3337,54.1,151,2.4,84,1.4,76,1.2,8,0.1,2593,42.1
W02000018,4980,100,2794,56.1,2638,53,156,3.1,100,2,86,1.7,14,0.3,2086,41.9
W02000019,5634,100,2931,52,2782,49.4,149,2.6,83,1.5,69,1.2,14,0.2,2620,46.5
W02000020,5450,100,2936,53.9,2847,52.2,89,1.6,73,1.3,64,1.2,9,0.2,2441,44.8
W02000021,6429,100,3579,55.7,3416,53.1,163,2.5,53,0.8,46,0.7,7,0.1,2797,43.5
W02000022,4779,100,2365,49.5,2260,47.3,105,2.2,68,1.4,54,1.1,14,0.3,2346,49.1
W02000023,4439,100,2426,54.7,2340,52.7,86,1.9,53,1.2,45,1,8,0.2,1960,44.2
W02000024,4740,100,2832,59.7,2747,58,85,1.8,53,1.1,45,0.9,8,0.2,1855,39.1
W02000025,5202,100,2791,53.7,2643,50.8,148,2.8,84,1.6,61,1.2,23,0.4,2327,44.7
W02000026,6117,100,2858,46.7,2740,44.8,118,1.9,65,1.1,47,0.8,18,0.3,3194,52.2
W02000027,7380,100,3591,48.7,3353,45.4,238,3.2,108,1.5,81,1.1,27,0.4,3681,49.9
W02000028,5559,100,2624,47.2,2439,43.9,185,3.3,98,1.8,73,1.3,25,0.4,2837,51
W02000029,5195,100,2565,49.4,2466,47.5,99,1.9,81,1.6,68,1.3,13,0.3,2549,49.1
W02000030,5098,100,2224,43.6,2111,41.4,113,2.2,53,1,38,0.7,15,0.3,2821,55.3
W02000031,6854,100,3287,48,3064,44.7,223,3.3,108,1.6,98,1.4,10,0.1,3459,50.5
W02000032,7096,100,3713,52.3,3533,49.8,180,2.5,97,1.4,71,1,26,0.4,3286,46.3
W02000033,5680,100,2991,52.7,2736,48.2,255,4.5,100,1.8,83,1.5,17,0.3,2589,45.6
W02000034,6396,100,3491,54.6,3344,52.3,147,2.3,101,1.6,82,1.3,19,0.3,2804,43.8
W02000035,7157,100,3972,55.5,3728,52.1,244,3.4,146,2,100,1.4,46,0.6,3039,42.5
W02000036,9561,100,4363,45.6,4130,43.2,233,2.4,125,1.3,91,1,34,0.4,5073,53.1
W02000037,5860,100,3430,58.5,3280,56,150,2.6,104,1.8,80,1.4,24,0.4,2326,39.7
W02000038,5277,100,2801,53.1,2690,51,111,2.1,84,1.6,66,1.3,18,0.3,2392,45.3
W02000039,6568,100,3547,54,3379,51.4,168,2.6,115,1.8,95,1.4,20,0.3,2906,44.2
W02000040,5555,100,3349,60.3,3289,59.2,60,1.1,64,1.2,52,0.9,12,0.2,2142,38.6
W02000041,7125,100,4162,58.4,4023,56.5,139,2,99,1.4,85,1.2,14,0.2,2864,40.2
W02000042,4927,100,2376,48.2,2242,45.5,134,2.7,76,1.5,63,1.3,13,0.3,2475,50.2
W02000043,4363,100,2178,49.9,2050,47,128,2.9,78,1.8,51,1.2,27,0.6,2107,48.3
W02000044,4499,100,2196,48.8,2109,46.9,87,1.9,83,1.8,63,1.4,20,0.4,2220,49.3
W02000045,7743,100,3394,43.8,3025,39.1,369,4.8,141,1.8,109,1.4,32,0.4,4208,54.3
W02000047,4092,100,2106,51.5,1950,47.7,156,3.8,90,2.2,71,1.7,19,0.5,1896,46.3
W02000049,5442,100,3090,56.8,2981,54.8,109,2,71,1.3,50,0.9,21,0.4,2281,41.9
W02000050,5341,100,2992,56,2870,53.7,122,2.3,79,1.5,56,1,23,0.4,2270,42.5
W02000051,4532,100,2378,52.5,2309,50.9,69,1.5,43,0.9,32,0.7,11,0.2,2111,46.6
W02000052,4031,100,2130,52.8,2026,50.3,104,2.6,46,1.1,31,0.8,15,0.4,1855,46
W02000053,5227,100,3055,58.4,2995,57.3,60,1.1,95,1.8,80,1.5,15,0.3,2077,39.7
W02000054,5226,100,2928,56,2860,54.7,68,1.3,66,1.3,49,0.9,17,0.3,2232,42.7
W02000055,4699,100,2585,55,2472,52.6,113,2.4,86,1.8,67,1.4,19,0.4,2028,43.2
W02000056,4253,100,2520,59.3,2451,57.6,69,1.6,45,1.1,39,0.9,6,0.1,1688,39.7
W02000057,5339,100,2858,53.5,2772,51.9,86,1.6,86,1.6,72,1.3,14,0.3,2395,44.9
W02000419,9204,100,5009,54.4,4772,51.8,237,2.6,160,1.7,130,1.4,30,0.3,4035,43.8
W02000058,4383,100,2272,51.8,2151,49.1,121,2.8,44,1,29,0.7,15,0.3,2067,47.2
W02000059,5383,100,3086,57.3,2954,54.9,132,2.5,98,1.8,70,1.3,28,0.5,2199,40.9
W02000060,8651,100,4832,55.9,4584,53,248,2.9,168,1.9,119,1.4,49,0.6,3651,42.2
W02000061,6081,100,3631,59.7,3401,55.9,230,3.8,115,1.9,85,1.4,30,0.5,2335,38.4
W02000062,5087,100,3102,61,2998,58.9,104,2,86,1.7,64,1.3,22,0.4,1899,37.3
W02000063,6999,100,3948,56.4,3829,54.7,119,1.7,119,1.7,93,1.3,26,0.4,2932,41.9
W02000064,4957,100,2898,58.5,2748,55.4,150,3,105,2.1,74,1.5,31,0.6,1954,39.4
W02000065,5964,100,3783,63.4,3665,61.5,118,2,124,2.1,97,1.6,27,0.5,2057,34.5
W02000066,7898,100,4708,59.6,4494,56.9,214,2.7,120,1.5,99,1.3,21,0.3,3070,38.9
W02000067,5551,100,3413,61.5,3308,59.6,105,1.9,102,1.8,76,1.4,26,0.5,2036,36.7
W02000068,4387,100,2625,59.8,2508,57.2,117,2.7,66,1.5,47,1.1,19,0.4,1696,38.7
W02000069,5231,100,3034,58,2947,56.3,87,1.7,99,1.9,77,1.5,22,0.4,2098,40.1
W02000070,8784,100,5255,59.8,5114,58.2,141,1.6,189,2.2,144,1.6,45,0.5,3340,38
W02000071,5969,100,3362,56.3,3264,54.7,98,1.6,94,1.6,67,1.1,27,0.5,2513,42.1
W02000072,9467,100,6070,64.1,5826,61.5,244,2.6,173,1.8,130,1.4,43,0.5,3224,34.1
W02000073,8323,100,4612,55.4,4400,52.9,212,2.5,127,1.5,97,1.2,30,0.4,3584,43.1
W02000074,8045,100,4843,60.2,4626,57.5,217,2.7,127,1.6,93,1.2,34,0.4,3075,38.2
W02000075,5195,100,3250,62.6,3164,60.9,86,1.7,103,2,84,1.6,19,0.4,1842,35.5
W02000076,6200,100,3456,55.7,3337,53.8,119,1.9,94,1.5,70,1.1,24,0.4,2650,42.7
W02000077,5039,100,2935,58.2,2823,56,112,2.2,94,1.9,66,1.3,28,0.6,2010,39.9
W02000080,6276,100,3721,59.3,3587,57.2,134,2.1,155,2.5,118,1.9,37,0.6,2400,38.2
W02000081,4705,100,2648,56.3,2544,54.1,104,2.2,105,2.2,77,1.6,28,0.6,1952,41.5
W02000082,6078,100,3773,62.1,3630,59.7,143,2.4,131,2.2,101,1.7,30,0.5,2174,35.8
W02000083,6941,100,4294,61.9,4140,59.6,154,2.2,161,2.3,124,1.8,37,0.5,2486,35.8
W02000085,7616,100,4116,54,3963,52,153,2,205,2.7,155,2,50,0.7,3295,43.3
W02000087,5033,100,2554,50.7,2362,46.9,192,3.8,136,2.7,97,1.9,39,0.8,2343,46.6
W02000088,7219,100,4477,62,4264,59.1,213,3,254,3.5,190,2.6,64,0.9,2488,34.5
W02000089,6881,100,4088,59.4,3858,56.1,230,3.3,139,2,114,1.7,25,0.4,2654,38.6
W02000090,4614,100,2564,55.6,2465,53.4,99,2.1,90,2,61,1.3,29,0.6,1960,42.5
W02000091,5104,100,2983,58.4,2876,56.3,107,2.1,112,2.2,75,1.5,37,0.7,2009,39.4
W02000092,5450,100,3029,55.6,2876,52.8,153,2.8,117,2.1,90,1.7,27,0.5,2304,42.3
W02000093,5379,100,3257,60.6,3148,58.5,109,2,86,1.6,66,1.2,20,0.4,2036,37.9
W02000094,7107,100,3903,54.9,3672,51.7,231,3.3,114,1.6,85,1.2,29,0.4,3090,43.5
W02000095,5383,100,3098,57.6,3011,55.9,87,1.6,68,1.3,49,0.9,19,0.4,2217,41.2
W02000096,5351,100,3083,57.6,2946,55.1,137,2.6,82,1.5,65,1.2,17,0.3,2186,40.9
W02000424,5760,100,3077,53.4,2999,52.1,78,1.4,124,2.2,100,1.7,24,0.4,2559,44.4
W02000425,7177,100,3583,49.9,3425,47.7,158,2.2,86,1.2,56,0.8,30,0.4,3508,48.9
W02000426,8203,100,4478,54.6,4307,52.5,171,2.1,159,1.9,109,1.3,50,0.6,3566,43.5
W02000116,6168,100,3486,56.5,3383,54.8,103,1.7,80,1.3,62,1,18,0.3,2602,42.2
W02000117,8383,100,2365,28.2,2218,26.5,147,1.8,1245,14.9,764,9.1,481,5.7,4773,56.9
W02000118,5374,100,2666,49.6,2557,47.6,109,2,278,5.2,179,3.3,99,1.8,2430,45.2
W02000120,6108,100,3236,53,3125,51.2,111,1.8,62,1,48,0.8,14,0.2,2810,46
W02000122,5477,100,2773,50.6,2685,49,88,1.6,46,0.8,35,0.6,11,0.2,2658,48.5
W02000123,6460,100,3299,51.1,3172,49.1,127,2,114,1.8,89,1.4,25,0.4,3047,47.2
W02000124,7294,100,3479,47.7,3316,45.5,163,2.2,92,1.3,66,0.9,26,0.4,3723,51
W02000125,6394,100,3195,50,3097,48.4,98,1.5,72,1.1,54,0.8,18,0.3,3127,48.9
W02000421,9721,100,5343,55,5163,53.1,180,1.9,125,1.3,99,1,26,0.3,4253,43.8
W02000126,6924,100,3826,55.3,3717,53.7,109,1.6,88,1.3,65,0.9,23,0.3,3010,43.5
W02000127,8105,100,4049,50,3852,47.5,197,2.4,99,1.2,82,1,17,0.2,3957,48.8
W02000128,6222,100,3467,55.7,3340,53.7,127,2,57,0.9,44,0.7,13,0.2,2698,43.4
W02000129,5967,100,3365,56.4,3273,54.9,92,1.5,77,1.3,58,1,19,0.3,2525,42.3
W02000130,5320,100,3032,57,2835,53.3,197,3.7,91,1.7,71,1.3,20,0.4,2197,41.3
W02000131,5832,100,3200,54.9,3047,52.2,153,2.6,99,1.7,82,1.4,17,0.3,2533,43.4
W02000132,5932,100,3201,54,3096,52.2,105,1.8,104,1.8,84,1.4,20,0.3,2627,44.3
W02000133,6955,100,3706,53.3,3599,51.7,107,1.5,81,1.2,64,0.9,17,0.2,3168,45.5
W02000134,6979,100,3717,53.3,3552,50.9,165,2.4,73,1,60,0.9,13,0.2,3189,45.7
W02000135,5934,100,3006,50.7,2826,47.6,180,3,106,1.8,93,1.6,13,0.2,2822,47.6
W02000136,7184,100,3453,48.1,3327,46.3,126,1.8,71,1,56,0.8,15,0.2,3660,50.9
W02000137,5941,100,3238,54.5,3048,51.3,190,3.2,81,1.4,48,0.8,33,0.6,2622,44.1
W02000138,7823,100,4195,53.6,3877,49.6,318,4.1,103,1.3,86,1.1,17,0.2,3525,45.1
W02000139,6596,100,3264,49.5,3166,48,98,1.5,83,1.3,66,1,17,0.3,3249,49.3
W02000140,5836,100,3007,51.5,2802,48,205,3.5,78,1.3,60,1,18,0.3,2751,47.1
W02000141,5004,100,2464,49.2,2344,46.8,120,2.4,55,1.1,44,0.9,11,0.2,2485,49.7
W02000142,4697,100,2556,54.4,2465,52.5,91,1.9,51,1.1,42,0.9,9,0.2,2090,44.5
W02000143,4799,100,2536,52.8,2449,51,87,1.8,53,1.1,37,0.8,16,0.3,2210,46.1
W02000144,6565,100,3437,52.4,3315,50.5,122,1.9,71,1.1,46,0.7,25,0.4,3057,46.6
W02000145,6054,100,3231,53.4,3118,51.5,113,1.9,71,1.2,48,0.8,23,0.4,2752,45.5
W02000146,5595,100,3105,55.5,3016,53.9,89,1.6,73,1.3,63,1.1,10,0.2,2417,43.2
W02000147,6871,100,3981,57.9,3861,56.2,120,1.7,190,2.8,148,2.2,42,0.6,2700,39.3
W02000148,4240,100,2349,55.4,2229,52.6,120,2.8,102,2.4,83,2,19,0.4,1789,42.2
W02000149,5472,100,2789,51,2665,48.7,124,2.3,96,1.8,88,1.6,8,0.1,2587,47.3
W02000151,6055,100,3115,51.4,2909,48,206,3.4,64,1.1,50,0.8,14,0.2,2876,47.5
W02000152,7148,100,3574,50,3439,48.1,135,1.9,147,2.1,115,1.6,32,0.4,3427,47.9
W02000153,7338,100,3918,53.4,3813,52,105,1.4,78,1.1,61,0.8,17,0.2,3342,45.5
W02000154,6399,100,3292,51.4,3166,49.5,126,2,124,1.9,100,1.6,24,0.4,2983,46.6
W02000156,6934,100,3838,55.4,3706,53.4,132,1.9,131,1.9,110,1.6,21,0.3,2965,42.8
W02000157,8291,100,4667,56.3,4547,54.8,120,1.4,151,1.8,123,1.5,28,0.3,3473,41.9
W02000158,4839,100,2834,58.6,2727,56.4,107,2.2,95,2,83,1.7,12,0.2,1910,39.5
W02000159,5074,100,2486,49,2370,46.7,116,2.3,70,1.4,46,0.9,24,0.5,2518,49.6
W02000160,6316,100,3299,52.2,3206,50.8,93,1.5,111,1.8,94,1.5,17,0.3,2906,46
W02000161,4212,100,2157,51.2,2070,49.1,87,2.1,71,1.7,57,1.4,14,0.3,1984,47.1
W02000162,7006,100,3375,48.2,3174,45.3,201,2.9,124,1.8,92,1.3,32,0.5,3507,50.1
W02000163,4310,100,2344,54.4,2219,51.5,125,2.9,103,2.4,76,1.8,27,0.6,1863,43.2
W02000164,6241,100,3391,54.3,3256,52.2,135,2.2,134,2.1,103,1.7,31,0.5,2716,43.5
W02000165,5274,100,2908,55.1,2779,52.7,129,2.4,113,2.1,75,1.4,38,0.7,2253,42.7
W02000166,7232,100,4053,56,3871,53.5,182,2.5,141,1.9,104,1.4,37,0.5,3038,42
W02000167,8270,100,4346,52.6,4044,48.9,302,3.7,134,1.6,98,1.2,36,0.4,3790,45.8
W02000418,10270,100,5697,55.5,5527,53.8,170,1.7,115,1.1,82,0.8,33,0.3,4458,43.4
W02000168,5251,100,3021,57.5,2864,54.5,157,3,119,2.3,91,1.7,28,0.5,2111,40.2
W02000169,7477,100,3947,52.8,3795,50.8,152,2,177,2.4,133,1.8,44,0.6,3353,44.8
W02000170,7264,100,3947,54.3,3807,52.4,140,1.9,137,1.9,92,1.3,45,0.6,3180,43.8
W02000171,6830,100,4281,62.7,4167,61,114,1.7,164,2.4,130,1.9,34,0.5,2385,34.9
W02000172,8319,100,4755,57.2,4554,54.7,201,2.4,187,2.2,138,1.7,49,0.6,3377,40.6
W02000173,6291,100,4059,64.5,3949,62.8,110,1.7,132,2.1,97,1.5,35,0.6,2100,33.4
W02000174,7902,100,4464,56.5,4326,54.7,138,1.7,173,2.2,127,1.6,46,0.6,3265,41.3
W02000175,6099,100,3332,54.6,3117,51.1,215,3.5,122,2,103,1.7,19,0.3,2645,43.4
W02000176,7315,100,3638,49.7,3488,47.7,150,2.1,145,2,111,1.5,34,0.5,3532,48.3
W02000177,5628,100,3404,60.5,3275,58.2,129,2.3,137,2.4,108,1.9,29,0.5,2087,37.1
W02000178,6576,100,3240,49.3,3005,45.7,235,3.6,152,2.3,94,1.4,58,0.9,3184,48.4
W02000179,5471,100,2982,54.5,2892,52.9,90,1.6,121,2.2,101,1.8,20,0.4,2368,43.3
W02000180,6236,100,3240,52,3046,48.8,194,3.1,184,3,146,2.3,38,0.6,2812,45.1
W02000181,6072,100,3312,54.5,3149,51.9,163,2.7,149,2.5,125,2.1,24,0.4,2611,43
W02000182,6204,100,3560,57.4,3399,54.8,161,2.6,126,2,96,1.5,30,0.5,2518,40.6
W02000183,8480,100,4311,50.8,4018,47.4,293,3.5,363,4.3,243,2.9,120,1.4,3806,44.9
W02000184,5618,100,3023,53.8,2890,51.4,133,2.4,132,2.3,93,1.7,39,0.7,2463,43.8
W02000185,4278,100,2212,51.7,2150,50.3,62,1.4,72,1.7,48,1.1,24,0.6,1994,46.6
W02000186,6406,100,3024,47.2,2750,42.9,274,4.3,170,2.7,126,2,44,0.7,3212,50.1
W02000188,6705,100,3489,52,3242,48.4,247,3.7,284,4.2,191,2.8,93,1.4,2932,43.7
W02000189,6883,100,3470,50.4,3245,47.1,225,3.3,113,1.6,89,1.3,24,0.3,3300,47.9
W02000191,7748,100,3362,43.4,3175,41,187,2.4,633,8.2,447,5.8,186,2.4,3753,48.4
W02000192,8375,100,3347,40,3039,36.3,308,3.7,617,7.4,396,4.7,221,2.6,4411,52.7
W02000193,8120,100,2366,29.1,2145,26.4,221,2.7,1002,12.3,679,8.4,323,4,4752,58.5
W02000194,5687,100,2295,40.4,2223,39.1,72,1.3,236,4.1,148,2.6,88,1.5,3156,55.5
W02000195,4918,100,2327,47.3,2275,46.3,52,1.1,89,1.8,62,1.3,27,0.5,2502,50.9
W02000196,5314,100,2391,45,2272,42.8,119,2.2,91,1.7,55,1,36,0.7,2832,53.3
W02000197,5208,100,2541,48.8,2464,47.3,77,1.5,78,1.5,52,1,26,0.5,2589,49.7
W02000198,6233,100,2982,47.8,2881,46.2,101,1.6,129,2.1,105,1.7,24,0.4,3122,50.1
W02000428,8937,100,4554,51,4404,49.3,150,1.7,252,2.8,171,1.9,81,0.9,4131,46.2
W02000200,4206,100,2144,51,2044,48.6,100,2.4,55,1.3,38,0.9,17,0.4,2007,47.7
W02000201,4344,100,2277,52.4,2159,49.7,118,2.7,46,1.1,24,0.6,22,0.5,2021,46.5
W02000202,10261,100,5675,55.3,5456,53.2,219,2.1,195,1.9,155,1.5,40,0.4,4391,42.8
W02000204,5654,100,2996,53,2912,51.5,84,1.5,92,1.6,75,1.3,17,0.3,2566,45.4
W02000205,4898,100,2366,48.3,2283,46.6,83,1.7,74,1.5,55,1.1,19,0.4,2458,50.2
W02000206,5524,100,2559,46.3,2400,43.4,159,2.9,67,1.2,49,0.9,18,0.3,2898,52.5
W02000207,4450,100,2355,52.9,2285,51.3,70,1.6,73,1.6,58,1.3,15,0.3,2022,45.4
W02000208,10587,100,5125,48.4,4950,46.8,175,1.7,395,3.7,223,2.1,172,1.6,5067,47.9
W02000210,4935,100,2589,52.5,2449,49.6,140,2.8,77,1.6,66,1.3,11,0.2,2269,46
W02000211,6270,100,3243,51.7,3062,48.8,181,2.9,91,1.5,76,1.2,15,0.2,2936,46.8
W02000212,6385,100,3419,53.5,3277,51.3,142,2.2,101,1.6,84,1.3,17,0.3,2865,44.9
W02000213,5650,100,3096,54.8,3001,53.1,95,1.7,96,1.7,75,1.3,21,0.4,2458,43.5
W02000214,7750,100,3651,47.1,3452,44.5,199,2.6,140,1.8,98,1.3,42,0.5,3959,51.1
W02000215,7625,100,3788,49.7,3585,47,203,2.7,115,1.5,93,1.2,22,0.3,3722,48.8
W02000216,5971,100,3179,53.2,3033,50.8,146,2.4,94,1.6,68,1.1,26,0.4,2698,45.2
W02000217,5167,100,2855,55.3,2742,53.1,113,2.2,77,1.5,62,1.2,15,0.3,2235,43.3
W02000417,8366,100,4441,53.1,4221,50.5,220,2.6,136,1.6,110,1.3,26,0.3,3789,45.3
W02000427,9145,100,4621,50.5,4366,47.7,255,2.8,135,1.5,100,1.1,35,0.4,4389,48
W02000218,5287,100,2580,48.8,2398,45.4,182,3.4,71,1.3,49,0.9,22,0.4,2636,49.9
W02000219,5982,100,3161,52.8,2988,49.9,173,2.9,104,1.7,83,1.4,21,0.4,2717,45.4
W02000220,6476,100,3492,53.9,3307,51.1,185,2.9,101,1.6,71,1.1,30,0.5,2883,44.5
W02000221,6187,100,3446,55.7,3248,52.5,198,3.2,84,1.4,64,1,20,0.3,2657,42.9
W02000222,5157,100,2629,51,2510,48.7,119,2.3,94,1.8,69,1.3,25,0.5,2434,47.2
W02000223,4949,100,2875,58.1,2769,56,106,2.1,73,1.5,55,1.1,18,0.4,2001,40.4
W02000224,5262,100,3067,58.3,2919,55.5,148,2.8,84,1.6,64,1.2,20,0.4,2111,40.1
W02000225,7170,100,3910,54.5,3735,52.1,175,2.4,92,1.3,69,1,23,0.3,3168,44.2
W02000226,8292,100,4707,56.8,4554,54.9,153,1.8,157,1.9,119,1.4,38,0.5,3428,41.3
W02000227,5854,100,3271,55.9,3077,52.6,194,3.3,87,1.5,64,1.1,23,0.4,2496,42.6
W02000228,9931,100,5996,60.4,5784,58.2,212,2.1,156,1.6,116,1.2,40,0.4,3779,38.1
W02000229,5040,100,2663,52.8,2548,50.6,115,2.3,64,1.3,45,0.9,19,0.4,2313,45.9
W02000230,4790,100,2609,54.5,2530,52.8,79,1.6,71,1.5,54,1.1,17,0.4,2110,44.1
W02000231,6847,100,3758,54.9,3515,51.3,243,3.5,93,1.4,68,1,25,0.4,2996,43.8
W02000232,4758,100,2944,61.9,2845,59.8,99,2.1,76,1.6,55,1.2,21,0.4,1738,36.5
W02000233,4957,100,2728,55,2599,52.4,129,2.6,72,1.5,50,1,22,0.4,2157,43.5
W02000234,8496,100,5208,61.3,5025,59.1,183,2.2,173,2,136,1.6,37,0.4,3115,36.7
W02000235,8024,100,3719,46.3,3538,44.1,181,2.3,96,1.2,66,0.8,30,0.4,4209,52.5
W02000236,6028,100,2893,48,2750,45.6,143,2.4,84,1.4,57,0.9,27,0.4,3051,50.6
W02000237,5068,100,2886,56.9,2804,55.3,82,1.6,59,1.2,47,0.9,12,0.2,2123,41.9
W02000238,5442,100,2741,50.4,2654,48.8,87,1.6,67,1.2,50,0.9,17,0.3,2634,48.4
W02000239,6670,100,3852,57.8,3758,56.3,94,1.4,86,1.3,72,1.1,14,0.2,2732,41
W02000240,7190,100,4348,60.5,4178,58.1,170,2.4,129,1.8,102,1.4,27,0.4,2713,37.7
W02000241,8440,100,4916,58.2,4731,56.1,185,2.2,123,1.5,84,1,39,0.5,3401,40.3
W02000242,6787,100,3802,56,3655,53.9,147,2.2,62,0.9,44,0.6,18,0.3,2923,43.1
W02000243,7222,100,3914,54.2,3684,51,230,3.2,152,2.1,100,1.4,52,0.7,3156,43.7
W02000244,8254,100,4482,54.3,4320,52.3,162,2,140,1.7,106,1.3,34,0.4,3632,44
W02000245,6659,100,3998,60,3770,56.6,228,3.4,126,1.9,90,1.4,36,0.5,2535,38.1
W02000246,4597,100,2388,51.9,2328,50.6,60,1.3,73,1.6,60,1.3,13,0.3,2136,46.5
W02000247,7321,100,3805,52,3664,50,141,1.9,83,1.1,60,0.8,23,0.3,3433,46.9
W02000248,8384,100,5035,60.1,4695,56,340,4.1,161,1.9,127,1.5,34,0.4,3188,38
W02000249,7092,100,4095,57.7,3864,54.5,231,3.3,116,1.6,88,1.2,28,0.4,2881,40.6
W02000250,9381,100,5560,59.3,5326,56.8,234,2.5,195,2.1,171,1.8,24,0.3,3626,38.7
W02000251,8950,100,5447,60.9,5202,58.1,245,2.7,115,1.3,82,0.9,33,0.4,3388,37.9
W02000367,5130,100,2881,56.2,2800,54.6,81,1.6,93,1.8,61,1.2,32,0.6,2156,42
W02000368,4715,100,2986,63.3,2885,61.2,101,2.1,93,2,80,1.7,13,0.3,1636,34.7
W02000369,7701,100,5586,72.5,5443,70.7,143,1.9,160,2.1,129,1.7,31,0.4,1955,25.4
W02000370,5472,100,2950,53.9,2862,52.3,88,1.6,88,1.6,65,1.2,23,0.4,2434,44.5
W02000371,7313,100,4209,57.6,4055,55.4,154,2.1,119,1.6,91,1.2,28,0.4,2985,40.8
W02000372,6595,100,4055,61.5,3917,59.4,138,2.1,111,1.7,84,1.3,27,0.4,2429,36.8
W02000373,5365,100,2911,54.3,2727,50.8,184,3.4,123,2.3,99,1.8,24,0.4,2331,43.4
W02000374,4696,100,2571,54.7,2489,53,82,1.7,84,1.8,52,1.1,32,0.7,2041,43.5
W02000375,5478,100,3138,57.3,2955,53.9,183,3.3,135,2.5,111,2,24,0.4,2205,40.3
W02000376,5355,100,3176,59.3,3046,56.9,130,2.4,67,1.3,53,1,14,0.3,2112,39.4
W02000377,6052,100,3847,63.6,3709,61.3,138,2.3,118,1.9,86,1.4,32,0.5,2087,34.5
W02000378,6054,100,3510,58,3420,56.5,90,1.5,105,1.7,69,1.1,36,0.6,2439,40.3
W02000379,4649,100,2381,51.2,2132,45.9,249,5.4,104,2.2,63,1.4,41,0.9,2164,46.5
W02000380,6513,100,3792,58.2,3684,56.6,108,1.7,134,2.1,100,1.5,34,0.5,2587,39.7
W02000381,5099,100,2924,57.3,2756,54,168,3.3,110,2.2,78,1.5,32,0.6,2065,40.5
W02000382,4529,100,2224,49.1,2050,45.3,174,3.8,116,2.6,84,1.9,32,0.7,2189,48.3
W02000383,5713,100,3129,54.8,2924,51.2,205,3.6,156,2.7,112,2,44,0.8,2428,42.5
W02000384,4642,100,2799,60.3,2717,58.5,82,1.8,115,2.5,86,1.9,29,0.6,1728,37.2
W02000385,5538,100,2711,49,2601,47,110,2,226,4.1,157,2.8,69,1.2,2601,47
W02000386,6224,100,3483,56,3382,54.3,101,1.6,89,1.4,64,1,25,0.4,2652,42.6
W02000387,4870,100,2755,56.6,2670,54.8,85,1.7,141,2.9,86,1.8,55,1.1,1974,40.5
W02000388,4758,100,2755,57.9,2650,55.7,105,2.2,93,2,67,1.4,26,0.5,1910,40.1
W02000389,6653,100,3930,59.1,3724,56,206,3.1,129,1.9,98,1.5,31,0.5,2594,39
W02000390,5251,100,2501,47.6,2428,46.2,73,1.4,183,3.5,120,2.3,63,1.2,2567,48.9
W02000391,8382,100,3140,37.5,2974,35.5,166,2,859,10.2,567,6.8,292,3.5,4383,52.3
W02000392,7378,100,4102,55.6,3966,53.8,136,1.8,207,2.8,139,1.9,68,0.9,3069,41.6
W02000393,5188,100,3060,59,2889,55.7,171,3.3,107,2.1,83,1.6,24,0.5,2021,39
W02000394,9024,100,2421,26.8,2283,25.3,138,1.5,1548,17.2,1109,12.3,439,4.9,5055,56
W02000395,5367,100,3364,62.7,3204,59.7,160,3,148,2.8,108,2,40,0.7,1855,34.6
W02000396,6615,100,3622,54.8,3411,51.6,211,3.2,633,9.6,465,7,168,2.5,2360,35.7
W02000397,5303,100,2921,55.1,2794,52.7,127,2.4,117,2.2,92,1.7,25,0.5,2265,42.7
W02000398,11868,100,1998,16.8,1831,15.4,167,1.4,1994,16.8,1284,10.8,710,6,7876,66.4
W02000399,9845,100,4598,46.7,4229,43,369,3.7,978,9.9,680,6.9,298,3,4269,43.4
W02000400,5467,100,3829,70,3694,67.6,135,2.5,114,2.1,100,1.8,14,0.3,1524,27.9
W02000401,4867,100,3136,64.4,3024,62.1,112,2.3,81,1.7,64,1.3,17,0.3,1650,33.9
W02000402,9918,100,4351,43.9,3982,40.1,369,3.7,744,7.5,463,4.7,281,2.8,4823,48.6
W02000403,5897,100,3522,59.7,3291,55.8,231,3.9,134,2.3,102,1.7,32,0.5,2241,38
W02000404,5210,100,3034,58.2,2794,53.6,240,4.6,146,2.8,109,2.1,37,0.7,2030,39
W02000405,5360,100,2589,48.3,2309,43.1,280,5.2,99,1.8,78,1.5,21,0.4,2672,49.9
W02000406,8172,100,5349,65.5,5133,62.8,216,2.6,211,2.6,138,1.7,73,0.9,2612,32
W02000407,4949,100,2501,50.5,2334,47.2,167,3.4,143,2.9,78,1.6,65,1.3,2305,46.6
W02000408,5873,100,3205,54.6,2928,49.9,277,4.7,252,4.3,178,3,74,1.3,2416,41.1
W02000409,4692,100,2542,54.2,2312,49.3,230,4.9,101,2.2,73,1.6,28,0.6,2049,43.7
W02000410,6776,100,3740,55.2,3446,50.9,294,4.3,423,6.2,236,3.5,187,2.8,2613,38.6
W02000411,5130,100,2740,53.4,2530,49.3,210,4.1,120,2.3,86,1.7,34,0.7,2270,44.2
W02000412,5415,100,2994,55.3,2821,52.1,173,3.2,167,3.1,128,2.4,39,0.7,2254,41.6
W02000422,6658,100,5053,75.9,4867,73.1,186,2.8,197,3,157,2.4,40,0.6,1408,21.1
W02000423,8588,100,4731,55.1,4426,51.5,305,3.6,559,6.5,321,3.7,238,2.8,3298,38.4
W02000252,7350,100,3564,48.5,3354,45.6,210,2.9,115,1.6,71,1,44,0.6,3671,49.9
W02000253,5675,100,3027,53.3,2885,50.8,142,2.5,98,1.7,80,1.4,18,0.3,2550,44.9
W02000254,6554,100,3422,52.2,3258,49.7,164,2.5,106,1.6,84,1.3,22,0.3,3026,46.2
W02000255,5669,100,3018,53.2,2877,50.7,141,2.5,85,1.5,55,1,30,0.5,2566,45.3
W02000256,8047,100,4339,53.9,4121,51.2,218,2.7,156,1.9,113,1.4,43,0.5,3552,44.1
W02000257,5972,100,3095,51.8,2912,48.8,183,3.1,102,1.7,84,1.4,18,0.3,2775,46.5
W02000258,4624,100,2347,50.8,2157,46.6,190,4.1,55,1.2,35,0.8,20,0.4,2222,48.1
W02000259,4579,100,2294,50.1,2161,47.2,133,2.9,67,1.5,43,0.9,24,0.5,2218,48.4
W02000260,4703,100,2215,47.1,2074,44.1,141,3,71,1.5,47,1,24,0.5,2417,51.4
W02000261,6346,100,3348,52.8,3144,49.5,204,3.2,87,1.4,58,0.9,29,0.5,2911,45.9
W02000262,4277,100,2319,54.2,2234,52.2,85,2,60,1.4,47,1.1,13,0.3,1898,44.4
W02000263,5109,100,2842,55.6,2710,53,132,2.6,61,1.2,46,0.9,15,0.3,2206,43.2
W02000264,4574,100,2344,51.2,2176,47.6,168,3.7,70,1.5,54,1.2,16,0.3,2160,47.2
W02000265,7498,100,3987,53.2,3738,49.9,249,3.3,125,1.7,97,1.3,28,0.4,3386,45.2
W02000266,6005,100,3310,55.1,3107,51.7,203,3.4,84,1.4,73,1.2,11,0.2,2611,43.5
W02000267,5146,100,2848,55.3,2636,51.2,212,4.1,98,1.9,74,1.4,24,0.5,2200,42.8
W02000268,7444,100,4030,54.1,3837,51.5,193,2.6,122,1.6,98,1.3,24,0.3,3292,44.2
W02000269,6691,100,3568,53.3,3395,50.7,173,2.6,107,1.6,60,0.9,47,0.7,3016,45.1
W02000270,5458,100,3205,58.7,3062,56.1,143,2.6,97,1.8,82,1.5,15,0.3,2156,39.5
W02000271,4413,100,2297,52.1,2149,48.7,148,3.4,58,1.3,43,1,15,0.3,2058,46.6
W02000272,8290,100,4642,56,4451,53.7,191,2.3,185,2.2,136,1.6,49,0.6,3463,41.8
W02000273,8713,100,3659,42,3358,38.5,301,3.5,810,9.3,551,6.3,259,3,4244,48.7
W02000274,8228,100,4835,58.8,4625,56.2,210,2.6,161,2,129,1.6,32,0.4,3232,39.3
W02000275,4975,100,2744,55.2,2646,53.2,98,2,89,1.8,69,1.4,20,0.4,2142,43.1
W02000276,5294,100,2777,52.5,2646,50,131,2.5,89,1.7,65,1.2,24,0.5,2428,45.9
W02000277,5798,100,3341,57.6,3223,55.6,118,2,86,1.5,61,1.1,25,0.4,2371,40.9
W02000278,7265,100,4578,63,4457,61.3,121,1.7,143,2,113,1.6,30,0.4,2544,35
W02000279,6273,100,3776,60.2,3617,57.7,159,2.5,107,1.7,80,1.3,27,0.4,2390,38.1
W02000280,7560,100,4800,63.5,4642,61.4,158,2.1,163,2.2,122,1.6,41,0.5,2597,34.4
W02000281,6194,100,3497,56.5,3387,54.7,110,1.8,113,1.8,84,1.4,29,0.5,2584,41.7
W02000282,9120,100,5637,61.8,5504,60.4,133,1.5,138,1.5,96,1.1,42,0.5,3345,36.7
W02000290,7037,100,3499,49.7,3264,46.4,235,3.3,85,1.2,64,0.9,21,0.3,3453,49.1
W02000291,5779,100,3056,52.9,2886,49.9,170,2.9,81,1.4,45,0.8,36,0.6,2642,45.7
W02000292,4666,100,2446,52.4,2303,49.4,143,3.1,64,1.4,47,1,17,0.4,2156,46.2
W02000293,4875,100,2501,51.3,2338,48,163,3.3,83,1.7,59,1.2,24,0.5,2291,47
W02000294,4716,100,2462,52.2,2349,49.8,113,2.4,61,1.3,42,0.9,19,0.4,2193,46.5
W02000295,7673,100,4497,58.6,4330,56.4,167,2.2,122,1.6,80,1,42,0.5,3054,39.8
W02000296,6074,100,3191,52.5,3025,49.8,166,2.7,89,1.5,58,1,31,0.5,2794,46
W02000297,6212,100,3363,54.1,3220,51.8,143,2.3,117,1.9,86,1.4,31,0.5,2732,44
W02000298,5867,100,3365,57.4,3228,55,137,2.3,104,1.8,67,1.1,37,0.6,2398,40.9
W02000299,5121,100,2700,52.7,2575,50.3,125,2.4,71,1.4,56,1.1,15,0.3,2350,45.9
W02000300,6879,100,3669,53.3,3516,51.1,153,2.2,105,1.5,67,1,38,0.6,3105,45.1
W02000301,6401,100,3757,58.7,3595,56.2,162,2.5,115,1.8,86,1.3,29,0.5,2529,39.5
W02000302,8166,100,4622,56.6,4442,54.4,180,2.2,114,1.4,87,1.1,27,0.3,3430,42
W02000303,5800,100,3550,61.2,3382,58.3,168,2.9,86,1.5,65,1.1,21,0.4,2164,37.3
W02000304,4543,100,2603,57.3,2497,55,106,2.3,100,2.2,70,1.5,30,0.7,1840,40.5
W02000305,5029,100,2880,57.3,2744,54.6,136,2.7,67,1.3,42,0.8,25,0.5,2082,41.4
W02000306,4272,100,2353,55.1,2255,52.8,98,2.3,56,1.3,40,0.9,16,0.4,1863,43.6
W02000307,5071,100,2902,57.2,2731,53.9,171,3.4,110,2.2,76,1.5,34,0.7,2059,40.6
W02000308,7118,100,3946,55.4,3737,52.5,209,2.9,96,1.3,60,0.8,36,0.5,3076,43.2
W02000309,5557,100,3061,55.1,2917,52.5,144,2.6,77,1.4,68,1.2,9,0.2,2419,43.5
W02000310,4215,100,2317,55,2205,52.3,112,2.7,77,1.8,48,1.1,29,0.7,1821,43.2
W02000311,7847,100,4201,53.5,4007,51.1,194,2.5,154,2,125,1.6,29,0.4,3492,44.5
W02000312,5963,100,3253,54.6,3108,52.1,145,2.4,126,2.1,85,1.4,41,0.7,2584,43.3
W02000313,8587,100,5306,61.8,5140,59.9,166,1.9,164,1.9,115,1.3,49,0.6,3117,36.3
W02000314,5445,100,2804,51.5,2655,48.8,149,2.7,73,1.3,62,1.1,11,0.2,2568,47.2
W02000315,4332,100,2385,55.1,2252,52,133,3.1,75,1.7,47,1.1,28,0.6,1872,43.2
W02000316,5512,100,2865,52,2717,49.3,148,2.7,95,1.7,63,1.1,32,0.6,2552,46.3
W02000317,6400,100,3533,55.2,3336,52.1,197,3.1,132,2.1,99,1.5,33,0.5,2735,42.7
W02000318,7425,100,3962,53.4,3732,50.3,230,3.1,120,1.6,84,1.1,36,0.5,3343,45
W02000319,6669,100,3612,54.2,3448,51.7,164,2.5,99,1.5,66,1,33,0.5,2958,44.4
W02000320,6739,100,3826,56.8,3621,53.7,205,3,112,1.7,85,1.3,27,0.4,2801,41.6
W02000321,7087,100,3807,53.7,3624,51.1,183,2.6,100,1.4,73,1,27,0.4,3180,44.9
W02000322,5534,100,2973,53.7,2783,50.3,190,3.4,80,1.4,54,1,26,0.5,2481,44.8
W02000323,4820,100,2608,54.1,2475,51.3,133,2.8,74,1.5,51,1.1,23,0.5,2138,44.4
W02000324,5606,100,3064,54.7,2905,51.8,159,2.8,80,1.4,63,1.1,17,0.3,2462,43.9
W02000325,5713,100,3046,53.3,2854,50,192,3.4,98,1.7,77,1.3,21,0.4,2569,45
W02000326,7290,100,3990,54.7,3811,52.3,179,2.5,117,1.6,97,1.3,20,0.3,3183,43.7
W02000327,5016,100,2580,51.4,2475,49.3,105,2.1,66,1.3,51,1,15,0.3,2370,47.2
W02000328,6194,100,3673,59.3,3533,57,140,2.3,94,1.5,75,1.2,19,0.3,2427,39.2
W02000329,6590,100,3854,58.5,3676,55.8,178,2.7,111,1.7,90,1.4,21,0.3,2625,39.8
W02000330,5905,100,3143,53.2,3012,51,131,2.2,111,1.9,84,1.4,27,0.5,2651,44.9
W02000331,4986,100,2729,54.7,2525,50.6,204,4.1,91,1.8,54,1.1,37,0.7,2166,43.4
W02000332,6167,100,3398,55.1,3171,51.4,227,3.7,67,1.1,42,0.7,25,0.4,2702,43.8
W02000333,5094,100,2949,57.9,2834,55.6,115,2.3,74,1.5,54,1.1,20,0.4,2071,40.7
W02000334,5491,100,3125,56.9,3002,54.7,123,2.2,115,2.1,84,1.5,31,0.6,2251,41
W02000335,6239,100,3598,57.7,3484,55.8,114,1.8,81,1.3,71,1.1,10,0.2,2560,41
W02000336,7397,100,3904,52.8,3812,51.5,92,1.2,84,1.1,69,0.9,15,0.2,3409,46.1
W02000337,6223,100,3215,51.7,3048,49,167,2.7,104,1.7,78,1.3,26,0.4,2904,46.7
W02000338,7182,100,3809,53,3650,50.8,159,2.2,91,1.3,70,1,21,0.3,3282,45.7
W02000339,9130,100,4882,53.5,4672,51.2,210,2.3,109,1.2,96,1.1,13,0.1,4139,45.3
W02000340,6143,100,3430,55.8,3346,54.5,84,1.4,53,0.9,38,0.6,15,0.2,2660,43.3
W02000341,7316,100,3824,52.3,3715,50.8,109,1.5,98,1.3,83,1.1,15,0.2,3394,46.4
W02000342,7900,100,4465,56.5,4339,54.9,126,1.6,90,1.1,64,0.8,26,0.3,3345,42.3
W02000343,6826,100,4142,60.7,3958,58,184,2.7,89,1.3,59,0.9,30,0.4,2595,38
W02000344,7146,100,4178,58.5,4066,56.9,112,1.6,111,1.6,86,1.2,25,0.3,2857,40
W02000345,6559,100,3616,55.1,3448,52.6,168,2.6,71,1.1,57,0.9,14,0.2,2872,43.8
W02000346,6418,100,4075,63.5,3975,61.9,100,1.6,119,1.9,103,1.6,16,0.2,2224,34.7
W02000347,6710,100,3703,55.2,3578,53.3,125,1.9,108,1.6,70,1,38,0.6,2899,43.2
W02000348,6297,100,3453,54.8,3311,52.6,142,2.3,94,1.5,58,0.9,36,0.6,2750,43.7
W02000349,6550,100,3447,52.6,3223,49.2,224,3.4,126,1.9,83,1.3,43,0.7,2977,45.5
W02000350,8034,100,5081,63.2,4932,61.4,149,1.9,133,1.7,104,1.3,29,0.4,2820,35.1
W02000351,4912,100,2718,55.3,2552,52,166,3.4,96,2,73,1.5,23,0.5,2098,42.7
W02000352,5399,100,3076,57,2922,54.1,154,2.9,137,2.5,96,1.8,41,0.8,2186,40.5
W02000353,5850,100,3722,63.6,3550,60.7,172,2.9,111,1.9,87,1.5,24,0.4,2017,34.5
W02000354,4877,100,2629,53.9,2490,51.1,139,2.9,105,2.2,80,1.6,25,0.5,2143,43.9
W02000355,8110,100,4989,61.5,4829,59.5,160,2,166,2,111,1.4,55,0.7,2955,36.4
W02000356,4017,100,2075,51.7,1907,47.5,168,4.2,74,1.8,42,1,32,0.8,1868,46.5
W02000357,6667,100,4025,60.4,3780,56.7,245,3.7,177,2.7,127,1.9,50,0.7,2465,37
W02000358,5413,100,3147,58.1,3045,56.3,102,1.9,94,1.7,64,1.2,30,0.6,2172,40.1
W02000359,9045,100,5700,63,5372,59.4,328,3.6,244,2.7,188,2.1,56,0.6,3101,34.3
W02000360,5812,100,3216,55.3,2963,51,253,4.4,142,2.4,121,2.1,21,0.4,2454,42.2
W02000361,9135,100,5344,58.5,5011,54.9,333,3.6,220,2.4,156,1.7,64,0.7,3571,39.1
W02000362,5623,100,3496,62.2,3411,60.7,85,1.5,99,1.8,69,1.2,30,0.5,2028,36.1
W02000363,4786,100,2613,54.6,2480,51.8,133,2.8,88,1.8,70,1.5,18,0.4,2085,43.6
W02000364,7008,100,3776,53.9,3460,49.4,316,4.5,237,3.4,188,2.7,49,0.7,2995,42.7
W02000365,6418,100,3977,62,3695,57.6,282,4.4,73,1.1,47,0.7,26,0.4,2368,36.9
W02000366,6754,100,4476,66.3,4351,64.4,125,1.9,110,1.6,90,1.3,20,0.3,2168,32.1
W02000097,7879,100,4466,56.7,4343,55.1,123,1.6,80,1,65,0.8,15,0.2,3333,42.3
W02000098,5317,100,3137,59,3057,57.5,80,1.5,65,1.2,56,1.1,9,0.2,2115,39.8
W02000099,5538,100,3156,57,2985,53.9,171,3.1,59,1.1,47,0.8,12,0.2,2323,41.9
W02000100,5270,100,3018,57.3,2927,55.5,91,1.7,39,0.7,35,0.7,4,0.1,2213,42
W02000101,4714,100,2749,58.3,2678,56.8,71,1.5,56,1.2,40,0.8,16,0.3,1909,40.5
W02000102,5199,100,3018,58,2942,56.6,76,1.5,76,1.5,69,1.3,7,0.1,2105,40.5
W02000103,4926,100,2878,58.4,2822,57.3,56,1.1,63,1.3,56,1.1,7,0.1,1985,40.3
W02000104,5217,100,2938,56.3,2796,53.6,142,2.7,81,1.6,62,1.2,19,0.4,2198,42.1
W02000105,3969,100,2303,58,2159,54.4,144,3.6,66,1.7,47,1.2,19,0.5,1600,40.3
W02000106,5494,100,3171,57.7,3055,55.6,116,2.1,43,0.8,31,0.6,12,0.2,2280,41.5
W02000107,8434,100,4563,54.1,4410,52.3,153,1.8,83,1,65,0.8,18,0.2,3788,44.9
W02000108,6145,100,3162,51.5,3078,50.1,84,1.4,70,1.1,56,0.9,14,0.2,2913,47.4
W02000109,4742,100,2348,49.5,2211,46.6,137,2.9,38,0.8,30,0.6,8,0.2,2356,49.7
W02000110,5818,100,3275,56.3,3186,54.8,89,1.5,62,1.1,55,0.9,7,0.1,2481,42.6
W02000111,7235,100,4106,56.8,4016,55.5,90,1.2,76,1.1,67,0.9,9,0.1,3053,42.2
W02000113,6895,100,3855,55.9,3712,53.8,143,2.1,81,1.2,71,1,10,0.1,2959,42.9
W02000114,5966,100,3103,52,3007,50.4,96,1.6,74,1.2,67,1.1,7,0.1,2789,46.7
W02000414,5107,100,3039,59.5,2967,58.1,72,1.4,50,1,41,0.8,9,0.2,2018,39.5
W02000416,8675,100,4525,52.2,4352,50.2,173,2,87,1,70,0.8,17,0.2,4063,46.8
W02000284,7626,100,4324,56.7,4132,54.2,192,2.5,160,2.1,104,1.4,56,0.7,3142,41.2
W02000285,6857,100,3877,56.5,3727,54.4,150,2.2,144,2.1,109,1.6,35,0.5,2836,41.4
W02000286,5482,100,2845,51.9,2664,48.6,181,3.3,76,1.4,48,0.9,28,0.5,2561,46.7
W02000287,6768,100,4027,59.5,3874,57.2,153,2.3,139,2.1,113,1.7,26,0.4,2602,38.4
W02000288,6641,100,3565,53.7,3349,50.4,216,3.3,94,1.4,66,1,28,0.4,2982,44.9
W02000289,7132,100,4065,57,3902,54.7,163,2.3,120,1.7,94,1.3,26,0.4,2947,41.3
W02000415,7172,100,3643,50.8,3387,47.2,256,3.6,106,1.5,67,0.9,39,0.5,3423,47.7
,,,,,,,,,,,,,,,,
,,,,,,,,,,,,,,,,
,,,,,,,,,,,,,,,,
,"In order to protect against disclosure of personal information, records",,,,,,,,,,,,,,,
,have been swapped between different geographic areas and counts perturbed,,,,,,,,,,,,,,,
,by small amounts. Small counts at the lowest geographies will be most,,,,,,,,,,,,,,,
,affected.,,,,,,,,,,,,,,,
